것	something	noun	이 안건이 통과되는 것에 반대하는 사람이 적어 표가 가에 몰릴 것으로 예상된다.
하다	do; perform	verb	가를 장식하다.
있다	existent; existing	adjective	물가가 점점 오르고 있다.
수	number; figure	noun	수필가
하다	do; perform	verb	가를 장식하다.
나	I	pronoun	열다섯 살인데 이 영화를 볼 수 있나요?
없다	non-existent	adjective	민준이는 공부를 잘해서 한 번도 가를 받은 적이 없다.
않다	do not	verb	이 가게는 가격 파괴라고 광고하지만 생각보다 가격이 많이 싼 것 같지 않다.
사람	human; man	noun	이 안건이 통과되는 것에 반대하는 사람이 적어 표가 가에 몰릴 것으로 예상된다.
우리	we	pronoun	우리 카페는 동물 입장 가입니다.
아니다	not	adjective	이것은 내가 어제 들었던 이야기가 아니다.
보다	see; look at; notice	verb	가게를 보다.
거	thing	noun	후보들은 가가호호 돌아다니며 선거 운동을 벌였다.
보다	see; look at; notice	verb	가게를 보다.
같다	same; identical; equal	adjective	그 상인은 올 겨울에는 배추 가격 인상으로 김치 가격도 상승할 것 같다고 했다.
주다	give	verb	가격표를 보여 주다.
대하다	face; confront	verb	가격 인상에 반대하다.
가다	go; travel	verb	가가호호 찾아가다.
년	year	noun	풍년가
한	one	adjective	민준이는 공부를 잘해서 한 번도 가를 받은 적이 없다.
말	speech; words	noun	말을 잘하는 사람은 상황에 맞게 말을 가감을 해서 말을 한다.
일	work; labor	noun	민준이는 금방이라도 일어날 듯이 의자 가에 엉덩이만 살짝 걸치고 앉았다.
이	tooth	noun	이가 아파요.
말하다	say; tell; speak; talk	verb	가리켜 말하다.
위하다	do in favor of; do for the benefit of	verb	고학생을 위하다.
그러나	but; however	adverb	글쎄요. 그러나 신제품 연구의 투자에도 신경을 써야 하지 않을까요.
오다	come	verb	가가 나오다.
알다	know; understand	verb	가족력을 알다.
씨	Mr.; Ms.; Mrs.	noun	안녕하세요 스미스씨!
그렇다	so; as such; like that	adjective	그렇다면 간단명료하게 요약해서 다시 보고서를 올리겠습니다.
크다	big; large	adjective	가능성이 크다.
일	work; labor	noun	요즘은 일이 힘들어.
사회	society	noun	그 드라마는 한국 사회의 현실을 가감 없이 드러냈다는 점에서 주목을 받았다.
많다	plentiful; many; a lot of	adjective	윗동네의 야채 가게는 신선한 야채들을 싼값에 팔아서 손님이 매우 많다.
안	not	adverb	저는 안 했어요.
좋다	good; great; excellent	adjective	가공성이 좋다.
더	more	adverb	아니요. 좀 더 신중하게 생각할 시간이 필요합니다.
받다	receive; get	verb	가를 받다.
집	house	noun	제 집이 아주 넓어요.
나오다	come out; get out	verb	가가 나오다.
그리고	and	adverb	이 책은 십 년 동안 서로를 기다린 연인의 감동적 사랑을 아름답게 그리고 있다.
문제	problem; question	noun	가감승제 문제.
그런	like that	adjective	가죽 가공이 잘못돼서 그런 것 같습니다. 바꿔 드리겠습니다.
살다	live; be alive	verb	가까이 살다.
저	I; me	pronoun	저는 대학생이에요.
못하다	be incapable; fail to	verb	김 대리는 시키는 일은 잘 해내지만 어쩐지 믿음직스럽지가 못하다.
생각하다	think	verb	가만히 생각하다.
모르다	not know	verb	가맣게 모르다.
속	inside stuff; interior; flesh	noun	네 마음 속에.
만들다	make; create; produce; manufacture	verb	가곡집을 만들다.
데	place	noun	좋은 데.
앞	front	noun	가게 앞에 도서관이 있어요.
경우	reason; principle	noun	이 가게의 경우, 가격표를 뗀 옷은 다른 옷으로 교환해 주지 않는다.
어떤	what	adjective	너는 어떤 음악을 주로 듣니?
잘	well	adverb	민준이는 공부를 잘해서 한 번도 가를 받은 적이 없다.
그녀	she; her	pronoun	그녀와 가까워지다.
먹다	eat; have; consume; take	verb	가끔 먹다.
자신	self; oneself	noun	선생님은 지금처럼만 공부하면 명문대 입학이 가능하다고 했지만 지수는 자신이 없었다.
문화	culture	noun	삼촌은 한국 전통문화를 소개해 주는 행사에서 가마를 메고 외국인들을 태웠다.
원	won	noun	이거 이천원이에요.
생각	thought	noun	아니요. 좀 더 신중하게 생각할 시간이 필요합니다.
어떻다	such	adjective	술 마시고 노래 좀 부른 거 갖고 뭐가 어떻다고 이래?
명	person	noun	제 가족은 세 명이에요.
통하다	flow; pass; circulate	verb	가미를 통하다.
그러다	do so	verb	네, 그러다 보니 출산 감소율이 높은 편이에요.
그러다	do so	verb	네, 그러다 보니 출산 감소율이 높은 편이에요.
소리	sound; noise	noun	바다 소리 잠 예뻐요.
다시	again	adverb	그럼 회사 가까이 와서 다시 연락 줘. 그때 내가 나갈게.
다른	different; other	adjective	이 가게의 경우, 가격표를 뗀 옷은 다른 옷으로 교환해 주지 않는다.
이런	this; such; of this kind	adjective	가다가 이런 날도 있어야지.
여자	woman	noun	친구는 나와 여자 친구를 화해하게 해 주어 사랑의 가교 역할을 하였다.
개	dog	noun	저는 개를 두 마리 있어요.
정도	degree	noun	정확히는 모르지만 이천 가구 정도가 사는 것 같아요.
다	all; everything	adverb	다 괜찮을 거예요.
좀	a little	adverb	아니요. 좀 더 신중하게 생각할 시간이 필요합니다.
싶다	sipda	adjective	이 영화에 나오는 마을 한번 가 보고 싶다.
보이다	be viewed; be visible; be in sight	verb	가관으로 보이다.
가지다	have; hold	verb	가변성을 가지다.
함께	together; along with	adverb	올림픽 개회식 때 남북한이 함께 입장을 한다며?
아이	child; kid	noun	부끄러움을 많이 타던 옆집 아이가 가수가 될 줄은 아무도 몰랐다.
지나다	pass; elapse	verb	가로를 지나다.
많이	much; in large numbers; in large amounts	adverb	부끄러움을 많이 타던 옆집 아이가 가수가 될 줄은 아무도 몰랐다.
시간	time	noun	아니요. 좀 더 신중하게 생각할 시간이 필요합니다.
인간	human; human being	noun	신화 속에 나오는 신들은 가공인물이지만 인간의 모습과 많이 닮았다.
사실	fact	noun	사실에 가깝다.
나다	grow; sprout	verb	나무가 나다.
이렇다	so; like this	adjective	부장은 이렇다 할 결론도 없이 회의를 두 시간이나 끌었다.
어머니	mother	noun	어머니는 싼 가격에 더 좋은 물건을 사기 위해 하루 종일 시장을 돌아다녔다.
눈	eye	noun	가공할 만한 눈바람에 눈을 제대로 뜰 수조차 없었다.
뭐	what	pronoun	너는 꿈이 뭐야?
점	point; dot	noun	그는 모든 점에서 나보다 낫다
의하다	be based on; be caused by; be grounded on	verb	우연성에 의하다.
시대	period	noun	조선 시대의 가객.
다음	next; following	noun	국회가 군대 파병 안을 가결하여 다음 달에 우리 군대가 파병될 것이다.
이러하다	such; of this kind; of this sort	adjective	상황이 이러이러하다.
곳	place; spot; location	noun	여기는 가공적 공간이라서 실제로는 없는 곳이야.
여러	several; many; a lot of	adjective	이번 반상회에는 사람들이 많이들 와야 여러 가지 사항을 결정할 텐데.
안	not	adverb	안 할 거예요.
하나	one	number	지수는 작은 과자 하나를 사도 가계부에 꼭 적는다.
세계	world; universe	noun	가공의 세계.
버리다	throw away; dump	verb	가맣게 잊어버리다.
위	top; higher part	noun	제 가방을 그 책상 위에 있어요.
운동	exercise	noun	건강하게 살고 싶으면 매일 운동을 해야 돼요.
퍼센트	percent	noun	우리는 공사 금액의 십 퍼센트를 먼저 받는 조건으로 가계약을 맺었다.
학교	school	noun	민준이가 용돈을 다 써서 학교에서 집까지 걸어갔다.
자기	his; her; he; she	pronoun	그 노인은 자기 의자에 털썩 앉았다.
가장	best	adverb	여행 중에 어떤 경치가 가장 좋았어?
대통령	president	noun	대통령은 국회에서 가결된 법률안을 거부할 수 있다.
가지	kind; sort	noun	이번 반상회에는 사람들이 많이들 와야 여러 가지 사항을 결정할 텐데.
시작하다	start; begin; initiate	verb	가동을 시작하다.
바로	straight; upright	adverb	새로 지은 건물에는 '바로 입주 가'라고 써 있는 현수막이 걸려 있었다.
어느	which	adjective	어느 나라 가고 싶어요?
그래서	so; therefore	adverb	그래서 저는 식구들의 휴대 전화 요금부터 줄여 보려고요.
무엇	what	pronoun	무엇보다 크고 무거워서 가동성이 떨어지는 게 흠이에요.
정부	government	noun	정부가 복구를 위한 조직을 구성해서 가동에 들어갔대.
모든	every	adjective	모든 의원들이 목소리를 높여 안건의 가결에 반대하였다.
돈	money	noun	돈 많은 남자를 저는 제일 좋아해요.
국가	state; nation; country	noun	그 국가는 영토를 확장하려고 하고 있었다.
그런데	by the way	adverb	네, 그런데 홍어가 가오리의 일종이라는 거 알고 계셨어요?
날	day	noun	이런 날 아주 행복해요.
여기	here; this	pronoun	종류에 따라 다릅니다. 여기 가격표를 한번 보시겠어요?
모두	all	noun	가가호호에 모두 전달했으니 많이 참석하겠지.
여성	woman	noun	광고에 나오는 여성들의 허리가 일반 여성보다 가느스름해 보인다.
친구	friend	noun	친구가 팔을 잘못 휘저어 제 코를 가격하는 바람에 코피가 났어요.
마음	personality	noun	동네 신발 가게에는 마음에 드는 신발이 없어 나는 결국 백화점에까지 갔다.
후	later time	noun	후에 과장을 먹을 거예요.
놓다	let go; let loose	verb	가교를 놓다.
관계	relationship	noun	가까워진 관계.
아버지	father; male parent	noun	할아버지는 늘 나에게 가계를 빛내는 훌륭한 사람이 되어야 한다고 강조하셨다.
남자	man; male	noun	선글라스를 낀 남자가 아까부터 아이를 쳐다본다.
어디	where	pronoun	차는 어디에 주차했어요?
몸	body	noun	몸을 가격하다.
얼굴	face	noun	경기 중 얼굴에 가격을 당해 부상을 입을 수도 있기 때문이지.
왜	why	adverb	마당에는 왜 나가려고?
나타나다	appear; come into sight	verb	가시적으로 나타나다.
지역	area; region	noun	이 지역은 가죽이 유명해서 구두, 가방, 가죽 장갑 등의 가공품이 많이 팔린다.
다르다	different; other	adjective	어쩐지 능숙하게 머리를 가위질하는 모습부터 남다르다 했어.
모습	appearance; look	noun	용은 가공의 동물이지만 그 모습은 동양과 서양에서 모두 비슷하다.
물	water	noun	드른 음료수 보다 물을 제일 맛있어요.
만나다	meet; join	verb	가까스로 만나다.
내다	make; build	verb	가게를 내다.
보이다	be viewed; be visible; be in sight	verb	가관으로 보이다.
쓰다	use; work with; make use of	verb	가계부를 쓰다.
이것	this	pronoun	이것은 내가 어제 들었던 이야기가 아니다.
없이	without	adverb	그 드라마는 한국 사회의 현실을 가감 없이 드러냈다는 점에서 주목을 받았다.
이번	this time	noun	이번 반상회에는 사람들이 많이들 와야 여러 가지 사항을 결정할 텐데.
길	road; street; way	noun	이것 제 가는 길이에요.
생활	life	noun	우리는 살림에 꼭 필요한 가구만을 장만해서 신혼 생활을 시작하였다.
쓰다	use; work with; make use of	verb	가계부를 쓰다.
사이	space; distance; gap	noun	가까워진 사이.
방법	way; means; manner	noun	할머니는 전통적인 가공 방법을 이용해 된장을 담그셨다.
새롭다	new; fresh	adjective	감회가 새롭다.
내다	make; build	verb	가게를 내다.
앉다	sit; be seated	verb	가에 앉다.
처음	first; forefront	noun	그러게 처음부터 그런 애랑 가까이 지내는 것이 아니었어.
손	hand	noun	지금 내 손을 잡아.
몇	some; several	number	큰길에 있는 옷집이 가격 파괴를 해서 싼 거 몇 벌 샀어.
그때	that time; that moment; then	noun	눈금이 백 가까이에 가면 위험하다는 신호니까 그때는 나를 불러야 된다.
과정	process	noun	가공 과정.
삶	living	noun	이 면은 언제까지 삶아야 되나요?
갖다	have; hold	verb	마음을 가뿐히 갖다.
찾다	find; look for	verb	가게를 찾다.
특히	specially; particularly; especially	adverb	배우들의 연기도 좋았고 특히 여주인공의 마지막 노래가 감동적이었어.
시	o'clock	noun	매일 여섯 시에 일어나요.
이상	or more; and over	noun	아니요, 이 영화는 십팔 세 이상 관람 가입니다.
지금	now	noun	슈베르트가 작곡한 가곡은 지금까지도 사람들에게 널리 사랑받는다.
나가다	go out; leave	verb	가도로 나가다.
이야기	story	noun	이것은 내가 어제 들었던 이야기가 아니다.
교육	education	noun	None available.
사다	buy; purchase; get	verb	가구점에서 가구를 사다.
경제	economy	noun	경제 불황으로 가계의 지출이 늘어나지 않고 있다.
아직	yet; still	adverb	이모가 아직 안 들어와서 나가 보려고요.
잡다	hold; grab; seize	verb	가닥을 잡다.
같이	together	adverb	너도 이리 가까이 와서 우리랑 같이 밥 먹자.
선생님	teacher; master	noun	수학 선생님께서 숙제를 내주셨는데 가감승제 문제가 삼십 개나 되었다.
예술	art	noun	예술가
서다	stand	verb	가격 인하에 나서다.
못	not	adverb	운동을 못 하는 지수는 체육 성적이 항상 가였다.
역사	history	noun	역사가
읽다	read; read out	verb	가끔 읽다.
결과	result; outcome	noun	글쎄요. 투표 결과를 지켜봐야 알 수 있을 것 같습니다.
내용	content; substance	noun	내용의 가감.
물론	of course	noun	물론입니다, 고객님.
책	books; publications	noun	책 가게.
일어나다	stand up; rise; sit up	verb	가급적 일찍 일어나다.
당신	you	pronoun	당신의 몸을 아름다운 몸매로 가꾸고 싶으십니까?
시장	market	noun	어머니는 싼 가격에 더 좋은 물건을 사기 위해 하루 종일 시장을 돌아다녔다.
넣다	put; insert	verb	가득 넣다.
중요하다	important	adjective	건조한 날씨에는 가슬가슬한 피부에 로션을 발라 보습하는 것이 중요하다.
무슨	what	adjective	병원에는 무슨 일로 가니?
느끼다	feel	verb	가까이 느끼다.
어렵다	difficult; challenging	adjective	가계가 어렵다.
힘	strength; power	noun	웃음만큼 가공할 힘을 가진 게 없지.
너무	too	adverb	이 건물 너무 많이 낡았다.
나라	country; nation; state	noun	그들은 시조로 한 나라에 이름을 떨친 유명한 가객들이었다.
부르다	call for; call out for; gesture	verb	가곡을 부르다.
의미	meaning; sense	noun	가벼운 의미.
자리	space; place	noun	가게 자리.
밝히다	light up; brighten up	verb	가를 밝히다.
죽다	die	verb	가스실에서 죽다.
이미	already	adverb	이미지가 가녀리다.
쪽	direction; way	noun	양 쪽 끝에서 여러 명이 잡아당겼더니 펴지더라.
정치	politics	noun	정치가
국민	people; national; citizen	noun	한국이 월드컵 본선에 진출하자 대한민국 국민들은 가열차게 한국을 응원했다.
생명	life	noun	거름기 없는 각박한 땅에서도 생명력 강한 잡초들은 자라고 있었다.
얘기	story	noun	그 일을 혼자 가누지 못할 것 같으면 저한테 얘기하세요.
학생	student; learner	noun	가감승제를 갓 배우기 시작한 학생들은 수학이 재미있다고 말했다.
연구	research; study	noun	연구가
엄마	mom	noun	엄마의 지난 가계부를 보면 그 당시의 물가를 쉽게 알 수 있다.
이름	name	noun	이름난 가객.
하나	one	number	지수는 작은 과자 하나를 사도 가계부에 꼭 적는다.
내리다	fall; descend	verb	가격을 내리다.
사건	incident; event; affair; accident; case	noun	판사의 역할은 사건의 시비를 가려내는 것이다.
및	besides; as well as	adverb	직원들은 미술관을 개관하기 전에 내부 정리 및 청소를 했다.
쉽다	easy	adjective	이 식당은 벽마다 가격표를 크게 붙여 놓아서 주문하기가 쉽다.
짓다	make	verb	가건물을 짓다.
이유	reason	noun	이유를 가르쳐 주다.
필요하다	necessary; needed	adjective	이 일을 한 달 안에 끝내려면 임시 부서의 가동이 필요하다.
글	writing; text	noun	그것은 한 편의 잘 다듬은 글이었다.
생기다	be formed; come into being	verb	가끔가다 생기다.
사용하다	use	verb	가끔 사용하다.
남편	husband	noun	남편은 삼대 독자로 가계를 이어 나갈 유일한 남자였다.
밖	outside	noun	응. 좀 나아졌어. 며칠 누워 있다가 오늘에야 가까스로 밖에 나왔어.
세상	world	noun	과거와 미래를 왔다 갔다 하는 건 가공적인 세상에서나 가능한 이야기겠지?
작다	small; little	adjective	가슴이 작다.
타다	ride; get on; board	verb	가루약을 타다.
대학	university; college	noun	동생은 대학을 졸업하고 변호사가 되었다.
작품	product; production	noun	가극 작품.
상황	situation; condition	noun	말을 잘하는 사람은 상황에 맞게 말을 가감을 해서 말을 한다.
가운데	center; middle	noun	방 한가운데에 가로대를 세워서 방을 두 칸으로 나눌 거야.
보내다	send	verb	가정 통신문을 보내다.
즉	that is	adverb	오랫동안 국민을 불안하게 만든 살해범은 검거 즉시 사형 선고가 내려졌다.
상태	condition; state	noun	원래 상태에 가까워지다.
이후	later time; the future	noun	동생이 가출한 이후로 우리는 대문에 빗장을 가로지르지 않고 항상 문을 열어 두었다.
당시	then; at that time	noun	엄마의 지난 가계부를 보면 그 당시의 물가를 쉽게 알 수 있다.
문학	literature	noun	문학가
더욱	more; further	adverb	그녀와 나 사이에 있었던 추억들을 가만 돌이켜 보니 그녀가 더욱 그리워졌다.
아주	very; so; extremely	adverb	네. 아주 마음에 듭니다. 가계약 없이 바로 정식으로 계약하겠습니다.
지방	area; district	noun	이 검사는 지방에서 근무한 지 5년 만에 근무지가 바뀌어 서울 법원으로 가게 되었다.
밤	night; evening	noun	밤길을 가다.
높다	high; lofty	adjective	가능성이 높다.
최근	the latest; the most recent	noun	최근 해외에서 우리나라 스타들의 인기가 대단합니다.
현실	reality	noun	그 드라마는 한국 사회의 현실을 가감 없이 드러냈다는 점에서 주목을 받았다.
환경	environment	noun	가난한 환경.
컴퓨터	computer	noun	요즘 컴퓨터 한 대 가격은 얼마나 합니까?
먼저	earlier; first	adverb	우리는 공사 금액의 십 퍼센트를 먼저 받는 조건으로 가계약을 맺었다.
다니다	go continuously	verb	가가호호를 찾아다니다.
얼마나	how	adverb	요즘 컴퓨터 한 대 가격은 얼마나 합니까?
자체	self	noun	헌법 재판소는 김 모 씨가 제기한 헌법 소원에 대해 청구 자체가 부적합하다며 각하하였다.
열다	open; unlock	verb	열다섯 살인데 이 영화를 볼 수 있나요?
머리	head	noun	누군가 내 머리를 돌로 가격하고 지갑을 뺏어 달아났다.
묻다	ask; inquire; interrogate	verb	가볍게 묻다.
남다	remain; be left	verb	가까이 남다.
부분	part	noun	그래? 대부분의 이야기들은 사람들이 가공한 게 아닐까?
기업	company; enterprise; business	noun	김 사장은 대기업의 횡포에 가만히 당하지 않고 신제품을 개발했다.
변화	change	noun	변화 가능성.
아들	son	noun	나는 내 재산의 절반에 가까운 돈을 아들에게 주었다.
아	oh; ah	interjection	아, 그렇게요.
선거	election	noun	후보들은 가가호호 돌아다니며 선거 운동을 벌였다.
관하다	concern	verb	간담회를 주관하다.
그냥	as it is; as it stands	adverb	한 두어 달 가난하게 지낼 생각으로 그냥 사 버렸지.
나누다	divide; split	verb	가닥을 나누다.
이용하다	use; utilize	verb	가맹점을 이용하다.
거의	most; almost	noun	좌석이 거의 다 찬 것을 보니 이백 명 가까이 온 것 같습니다.
곧	immediately	adverb	곧 표결을 시작하오니 가인지 부인지 여부를 정해 주시기 바랍니다.
중심	center	noun	중심가
활동	activity; movement	noun	활동가
오늘	today	noun	여보. 오늘은 장사가 안 되니 가게 문 닫고 집에서 저녁 먹읍시다.
서로	each other; one another	adverb	서로 가까워지다.
관심	interest; attention	noun	할머니는 가는귀먹은 사람처럼 다른 사람들의 대화에 관심 없이 앉아 계셨다.
역시	also; as well	adverb	최근 큰 인기를 얻고 있는 배우들의 가세 역시 영화에 대한 관심을 가열하고 있다.
이거	this	pronoun	응. 이거 진짜 소가죽으로 만든 거라 따뜻하고 좋아.
애	child; kid	noun	None available.
광고	advertisement; publicity	noun	이 가게는 가격 파괴라고 광고하지만 생각보다 가격이 많이 싼 것 같지 않다.
나다	grow; sprout	verb	가계가 살아나다.
방	room	noun	이 방에서 태어났어요.
정신	spirit; mind	noun	정신을 가누다.
이르다	early; premature	adjective	가도에 이르다.
이루다	form; make	verb	가정을 이루다.
아침	morning	noun	형은 용돈을 벌기 위해 아침마다 가가호호를 돌며 신문을 돌렸다.
웃다	smile	verb	가식적으로 웃다.
현상	phenomenon	noun	가변적인 현상.
기술	technology	noun	가공 기술.
전체	whole	noun	회사 전체 이익과 관련되어 있으니 그리 가볍게 보아 넘길 문제는 아니야.
그래	okay; sure	interjection	그래요. 가는 길에 반찬 가게에서 저녁 반찬 좀 사 가요.
얻다	get; receive	verb	가르침을 얻다.
아름답다	beautiful; pretty	adjective	저는 특히 지붕의 곡선이 참 아름답다고 생각해요.
끝	end; final	noun	가교 공사가 끝나면 차들이 강을 빨리 건너갈 수 있다.
민족	people; ethnic group; race	noun	아이들은 한국 전쟁이 우리 민족에게 얼마나 큰 슬픔을 가져다줬는지 잘 모른다.
간	liver	noun	None available.
조사	poll; survey; investigation	noun	장 교수는 논문에서 설문 조사 결과를 통해 자신의 가설을 뒷받침했다.
듯	deut	noun	민준이는 금방이라도 일어날 듯이 의자 가에 엉덩이만 살짝 걸치고 앉았다.
입	mouth	noun	None available.
뭐	what	pronoun	너는 꿈이 뭐야?
그대로	as it is; as it stands	adverb	아버지는 가공되지 않은 자연 그대로의 채소를 즐겨 드신다.
영화	film; movie	noun	아니요, 이 영화는 십팔 세 이상 관람 가입니다.
필요	need; necessity; requirement	noun	아니요. 좀 더 신중하게 생각할 시간이 필요합니다.
줄	rope; string	noun	부끄러움을 많이 타던 옆집 아이가 가수가 될 줄은 아무도 몰랐다.
하늘	sky	noun	하늘을 가르다.
과학	science	noun	과학적 가설.
자연	nature	noun	아버지는 가공되지 않은 자연 그대로의 채소를 즐겨 드신다.
정말	fact	noun	응, 술병을 던지면서 고함을 치는 게 정말 가관이더라.
구조	constitution; organization; structure	noun	이 아파트는 공간 활용이 용이한 가변 구조로 설계되었다.
결국	eventually; finally	adverb	동네 신발 가게에는 마음에 드는 신발이 없어 나는 결국 백화점에까지 갔다.
밥	steamed rice; rice	noun	너도 이리 가까이 와서 우리랑 같이 밥 먹자.
입다	wear; be dressed; put on	verb	가볍게 입다.
오히려	on the contrary	adverb	아니야. 승규는 좋아하는 사람한테 오히려 더 냉정하게 대해.
프로그램	program; list of shows	noun	간소화한 프로그램.
네	yes; yes sir; yes ma'am	interjection	네 성적표에 가도 있어?
이루어지다	be done; be formed	verb	가격 인상이 이루어지다.
남	others; another person	noun	선글라스를 낀 남자가 아까부터 아이를 쳐다본다.
하루	day	noun	어머니는 싼 가격에 더 좋은 물건을 사기 위해 하루 종일 시장을 돌아다녔다.
그림	drawing; painting; sketch	noun	그림자는 정오에 가까워질수록 짧아진다.
적	enemy	noun	네 성적표에 가도 있어?
터	lot; site	noun	선글라스를 낀 남자가 아까부터 아이를 쳐다본다.
마시다	drink	verb	가끔가다가 술을 마시다.
치다	hit; strike	verb	가에 걸치다.
혼자	being alone; being by oneself	noun	혼자 사는 노인과 젊은이가 많아지면서 일인 가구 수가 증가하고 있다.
나가다	go out; leave	verb	가도로 나가다.
이제	now	noun	우리 회원 수는 이제 구만 명으로, 목표로 한 십만 명에 가까워졌다.
교수	teaching; instruction	noun	장 교수는 논문에서 설문 조사 결과를 통해 자신의 가설을 뒷받침했다.
술	alcohol; liquor	noun	저는 술을 너무 많이 마셔요.
사랑	love	noun	슈베르트가 작곡한 가곡은 지금까지도 사람들에게 널리 사랑받는다.
전화	call; phone call	noun	인부들은 공사 현장의 가건물에 전화를 설치했다.
끝나다	end; finish	verb	가을이 끝나다.
맞다	be correct	verb	가랑비를 맞다.
아빠	dad; daddy	noun	승규는 아빠의 팔을 베고 가로누웠다.
걸리다	hang	verb	가시가 걸리다.
지키다	guard; defend	verb	가치 중립을 지키다.
한번	very; really; extremely	adverb	종류에 따라 다릅니다. 여기 가격표를 한번 보시겠어요?
커피	coffee fruit; coffee powder	noun	나는 커피 열매를 따서 말리는 가공법으로 커피를 만들었다.
가슴	chest	noun	놀란 가슴을 애써 진정시켰지만 두 시간이 지난 지금도 가슴이 가늘게 뛰었다.
길다	long; lengthy; extensive	adjective	가락이 길다.
바라보다	look; stare; gaze	verb	가소롭게 바라보다.
알아보다	investigate; examine; look into	verb	간략히 알아보다.
맛	taste	noun	별로 맛없어요.
대부분	most; bulk; majority	noun	그래? 대부분의 이야기들은 사람들이 가공한 게 아닐까?
산업	industry	noun	편리한 기계들이 많이 발명되면서 산업화가 더욱 가속되었다.
매우	very; very much; greatly	adverb	윗동네의 야채 가게는 신선한 야채들을 싼값에 팔아서 손님이 매우 많다.
오르다	go up; get on; climb; reach	verb	가격이 오르다.
음식	food	noun	요리사는 양념을 조금씩 가감해 가면서 음식 간을 맞췄다.
표정	facial expression	noun	가극은 이태리어로 공연되었지만 연기자들의 연기와 표정을 통해 내용을 짐작할 수 있었다.
꼭	without fail; at any cost; certainly	adverb	지수는 작은 과자 하나를 사도 가계부에 꼭 적는다.
일부	part; some; portion; fraction	noun	우리가 제시한 안이 가결만 된다면 내일부터 당장 일이 시작된다.
요즘	nowadays; these days	noun	요즘 컴퓨터 한 대 가격은 얼마나 합니까?
계획	plan; program; scheme; design	noun	계획안이 가결되다.
느낌	feeling; sense; impression	noun	가정적 느낌.
얼마	what amount; what number; what price	noun	요즘 컴퓨터 한 대 가격은 얼마나 합니까?
고개	head	noun	고개를 가누다.
성격	personality; character	noun	성격이 꼼꼼한 지수도 가끔가다 실수를 한다.
계속	continuance; succession	noun	아니, 가계를 책임져야 한다고 다른 일을 계속 하시겠대.
세기	century	noun	미국은 20세기 세계 최고의 강대 국가로 발전하였다.
세우다	pick up; raise up; make something stand	verb	가에 세우다.
아내	wife	noun	아내가 먼저 가는 바람에 3년째 혼자 살고 있습니다.
가족	family	noun	그는 병이 심해져 죽음이 가까워지자 가족들을 모두 모이게 했다.
현재	now; present; today	noun	나는 지도를 보며 나의 현재 위치를 가늠해 보았다.
세	three	adjective	저는 개가 세 마리 있어요.
발전	development; advancement	noun	발전 가능성.
차	car; automobile; vehicle	noun	차는 어디에 주차했어요?
놀다	play; have fun	verb	가라오케에서 놀다.
향하다	face; turn; direct	verb	결승선을 향하다.
관련	being related	noun	회사 전체 이익과 관련되어 있으니 그리 가볍게 보아 넘길 문제는 아니야.
형태	form; shape	noun	과일은 주스나 통조림처럼 가공된 형태로도 먹을 수 있다.
각	each; every	adjective	None available.
도시	city	noun	도시로 인구가 집중되면서 도시 가구 수가 농촌 가구 수의 일곱 배를 넘어섰다.
작업	work	noun	피해 복구 팀이 가동하면 본격적인 복구 작업이 이루어질 것이다.
분위기	mood	noun	그는 봄을 맞아 집안 분위기를 바꾸려고 가구를 달리 배치하였다.
그러하다	so; as such; like that	adjective	그녀는 남의 시선이 그러하다는 이유로 짧은 치마를 잘 입지 않는다.
나이	age	noun	글쎄, 외모만으로는 나이를 가늠을 못하겠어.
우선	first of all; to begin with; before everything	adverb	어제 둘러본 집이 마음에 들어 우선 가계약부터 하기로 했다.
믿다	believe; trust	verb	가능성을 믿다.
바꾸다	change; exchange; replace; turn into	verb	가스통을 바꾸다.
낳다	give birth; deliver	verb	갈등을 낳다.
정보	information; data	noun	객관적인 정보를 전달하는 기사문에서 가정법을 많이 쓰는 것은 바람직하지 않다.
열리다	open; be unlocked; unlock	verb	가지에 열매가 열리다.
좋아하다	like	verb	강호를 좋아하다.
그리다	draw; paint	verb	가로축을 그리다.
배우다	learn	verb	가감승제를 배우다.
시	o'clock	noun	None available.
역할	role; part	noun	가교 역할.
옆	side	noun	부끄러움을 많이 타던 옆집 아이가 가수가 될 줄은 아무도 몰랐다.
행동	action; movement behavior; deed	noun	행동이 가관이다.
어	oh no; what; huh	interjection	저기 운동장 가에 세워 뒀어요.
국내	interior of a country; domestic territory	noun	박 씨는 국내 최고의 제작자로 한국 가요계의 미래를 짊어질 사람이라는 평가를 받는다.
비하다	compare; be comparable	verb	가격 인하에 대비하다.
기관	engine	noun	가솔린 기관.
입장	position; situation; standpoint; ground; stance	noun	입장 가.
만하다	worth	adjective	가구를 장만하다.
예	yes sir; yes ma'am	interjection	None available.
아래	bottom; lower part	noun	버스가 빗길에 미끄러져 가드레일을 뚫고 언덕 아래로 추락했다.
방식	way; means	noun	아무래도 세대가 다르다 보니 사고방식에 간극이 있는 모양이구나.
영향	influence	noun	가솔린 가격의 인상은 가솔린 엔진을 단 자동차의 판매에 영향을 미쳤다.
그럼	if so; in that case	adverb	그럼 우리나라 가극단이 공연을 하겠구나.
나서다	come out; come forward	verb	가격 인하에 나서다.
흐르다	flow; run	verb	세월이 흐르다 보니 나는 어린 시절 친구들과 뛰어놀던 기억조차 가물가물하다.
저	I; me	pronoun	처는 스미스예요.
깊다	deep	adjective	감개가 깊다.
배	abdomen; belly	noun	가가호호에 배부하다.
내	I	pronoun	이것은 내가 어제 들었던 이야기가 아니다.
모양	shape	noun	모양도 예쁘고, 네 몸매가 더 가느스름해 보여.
산	mountain	noun	None available.
새	new	adjective	새로 지은 건물에는 '바로 입주 가'라고 써 있는 현수막이 걸려 있었다.
하지만	but; however	adverb	이 가게는 가격 파괴라고 광고하지만 생각보다 가격이 많이 싼 것 같지 않다.
조건	condition	noun	우리가 제시한 사업 조건이 마음에 드십니까?
문	door	noun	창문가.
꽃	flower	noun	꽃 가게.
단계	phase; step	noun	가공 단계.
올리다	increase; raise	verb	가격을 올리다.
그동안	meantime; meanwhile	noun	그동안 바빠서 못했던 집안일을 하다 보니 하루가 다 갔네요.
교사	teacher	noun	지수는 초등학교 교사로 학교에서 아이들을 가르치고 있다.
갑자기	suddenly; all of a sudden	adverb	시계가 고장 났는지 갑자기 안 가네요.
넘다	exceed; go beyond	verb	가볍게 뛰어넘다.
지니다	keep	verb	가능성을 지니다.
바람	wind	noun	친구가 팔을 잘못 휘저어 제 코를 가격하는 바람에 코피가 났어요.
잘하다	do a right thing; do right	verb	가위질을 잘하다.
마을	town	noun	아이들은 새해를 맞아 가가호호를 찾아 다니며 마을 어른들께 인사를 드렸다.
어리다	young	adjective	감개가 어리다.
대표	representative	noun	계약서에 회사의 대표라고 적혀 있는 김 씨가 실제로는 존재하지 않는 가공인물인 것으로 밝혀졌다.
가능성	possibility; chance; likelihood	noun	가능성이 가늠되다.
방향	direction; side	noun	방향을 가늠하다.
대회	meeting; convention	noun	이번 합창 대회 때는 무슨 노래를 부르지?
목소리	voice	noun	모든 의원들이 목소리를 높여 안건의 가결에 반대하였다.
노래	song; music; singing	noun	가객이 노래하다.
바다	sea	noun	물에 빠진 그는 자신의 몸이 점점 바다 밑으로 가라앉는 것을 느꼈다.
힘들다	strenuous; laborious	adjective	가누기 힘들다.
공부	study	noun	민준이는 공부를 잘해서 한 번도 가를 받은 적이 없다.
움직이다	move; budge; be in motion	verb	가늘게 움직이다.
의원	member of an assembly; assemblyman	noun	과반수의 의원들이 찬성한 안건들은 곧바로 가결로 처리되었다.
노력	effort; endeavor; hard work	noun	모방은 원형에 가까워지려는 노력이다.
전혀	(not) at all; completely	adverb	우리는 김 선생님의 생각을 전혀 가늠할 수 없었다.
언니	older sister	noun	동생의 사고 소식을 들은 언니는 슬픔을 가눌 수가 없었다.
단체	group; society; association	noun	가담한 단체.
알려지다	become known	verb	거국에 알려지다.
가능하다	possible; able	adjective	가늠이 가능하다.
능력	ability; capability; competence	noun	가공할 만한 능력.
주장하다	assert; claim	verb	가열차게 주장하다.
자식	child; kid	noun	자식을 가르치다.
불	fire	noun	불이 아주 뜨거워요.
주민	resident	noun	시 의회는 주민의 안전을 위해 가로등을 설치하자는 안을 가결했다.
모으다	gather; collect; get together	verb	가닥가닥 모으다.
자료	material; data; reference	noun	인터넷상에는 사실을 믿을 수 없는 자료가 많은 것 같아.
존재	existence	noun	계약서에 회사의 대표라고 적혀 있는 김 씨가 실제로는 존재하지 않는 가공인물인 것으로 밝혀졌다.
학년	school year	noun	동생은 대학교 1학년을 마치고 군대를 가기로 결정했다.
신문	newspaper; paper	noun	형은 용돈을 벌기 위해 아침마다 가가호호를 돌며 신문을 돌렸다.
가지다	have; hold	verb	가변성을 가지다.
이해하다	understand; comprehend; figure out	verb	개념을 이해하다.
제품	product	noun	제품의 가격 인상.
분야	field; sphere	noun	유민이는 창의적이어서 미술 분야에서 성공할 가망성이 크다.
선생	teacher; instructor	noun	수학 선생님께서 숙제를 내주셨는데 가감승제 문제가 삼십 개나 되었다.
사업	business	noun	사업가
행위	act; action; conduct; deed	noun	가학 행위.
수준	standard; norm	noun	수준이 가늠되다.
지난해	last year	noun	아버지는 회사에서 삼십 년 가까이 일하고 지난해에 회사를 그만두었다.
표현	expression; representation	noun	가리키는 표현.
기분	mood; feelings	noun	가뜩 기분도 안 좋은데.
젊다	young	adjective	나이가 젊다.
옷	clothes; garment	noun	옷 가게.
기능	function; role	noun	기능을 가미하다.
순간	moment	noun	감격스러운 순간.
전쟁	war	noun	우리는 모두 전쟁을 반대하는 시위에 가담했다.
전	past	noun	다 전에 생긴 일들이에요.
꿈	dream	noun	너는 꿈이 뭐야?
할머니	grandmother; granny	noun	할머니는 전통적인 가공 방법을 이용해 된장을 담그셨다.
회의	meeting; conference	noun	그 드라마는 한국 사회의 현실을 가감 없이 드러냈다는 점에서 주목을 받았다.
방송	broadcasting	noun	None available.
이야기하다	tell; say; speak	verb	가만가만 이야기하다.
나무	tree	noun	나무가 지나치게 단단하면 변형이 어려워 가공성이 떨어진다.
자다	sleep	verb	가로누워서 자다.
연극	play; drama; theater	noun	가두 연극.
마찬가지	being the same	noun	자네는 우리에게 친자식과 마찬가지네.
걷다	walk	verb	가도를 걷다.
노동	labor; work	noun	가난한 노동자.
이때	this time; this moment; this instant	noun	좋습니다. 적들은 아마 우리가 이때 공격할 것이라고는 상상도 못할 겁니다.
과거	past	noun	과거와 미래를 왔다 갔다 하는 건 가공적인 세상에서나 가능한 이야기겠지?
가치	value	noun	네, 이번 작품은 가부장적 가치에 저항하는 내용이더라고요.
시간	time	noun	아니요. 좀 더 신중하게 생각할 시간이 필요합니다.
집단	group; body	noun	조선 시대의 가객들은 집단으로 서울 주변의 명승지를 돌아다니면서 노래를 부르곤 했다.
현대	(질문) present era; contemporary world	noun	현대 가곡집.
살펴보다	examine; check	verb	간략히 살펴보다.
장관	minister	noun	가위 장관이다.
차이	difference	noun	두 나라의 승점이 같으면 골 득실 차이로 순위가 가려진다.
풀다	untie	verb	가감승제를 풀다.
시절	days; the time	noun	나는 가난하게 자란 어린 시절을 생각하면 지금도 함부로 돈을 못 쓰겠다.
물건	article; thing; item; goods	noun	물건의 가격.
직접	direct relationship	noun	할머니는 어린 손자를 위해 재미있는 이야기를 직접 가공해서 들려 주곤 하셨다.
개인	each person; individual	noun	개인전을 가지다.
근데	by the way	noun	네. 근데 요즘은 다 기계로 썰어서 파는 것을 사잖아요.
발	foot	noun	None available.
작가	writer; author	noun	소설의 인물들은 모두 작가가 만들어 낸 가공의 인물이다.
효과	effect; efficacy	noun	새로 나온 가루비누는 찌든 때도 없애고 살균까지 하는 효과가 있다.
불교	Buddhism	noun	이 절에는 소중한 불교 미술품이 많이 간직되어 있다.
끌다	pull	verb	가요계를 이끌다.
대로	main street; main road	noun	아버지는 가공되지 않은 자연 그대로의 채소를 즐겨 드신다.
빨리	quickly	adverb	가교 공사가 끝나면 차들이 강을 빨리 건너갈 수 있다.
시작되다	start	verb	갓길이 시작되다.
말다	stop; choose not to	verb	친구와 사소한 말다툼을 한 이후로 좀처럼 거리감이 좁혀지지 않아서 고민이에요.
설명하다	explain; account for	verb	가리키며 설명하다.
우주	the universe	noun	우주를 가로지르다.
시기	time; period	noun	곧 표결을 시작하오니 가인지 부인지 여부를 정해 주시기 바랍니다.
마치	as if	adverb	나는 가끔씩 가공적 인물인 소설의 주인공이 마치 살아 있는 사람처럼 느껴졌다.
살	flesh; weight	noun	살을 빼려고 할 때에라도 아침은 먹을 수 있다.
생산	production	noun	우유 가공업이 발달하면서 치즈나 분유 등 다양한 제품이 생산되고 있다.
바라다	want; hope; wish	verb	간절히 바라다.
강하다	strong; powerful	adjective	가연성이 강하다.
경험	experience	noun	어제 텔레비전에 신기한 경험을 한 사람들의 이야기가 많이 나왔어.
음악	music	noun	음악가
최고	the highest; top	adjective	최고가
나타내다	appear; turn up; show up	verb	가분수로 나타내다.
아프다	hurting; aching	adjective	가끔가다가 아프다.
적다	little; a little	adjective	가계부를 적다.
비	rain	noun	비가 올까요?
고향	home; hometown	noun	요즘 바빠서 고향에 계신 부모님께 전화도 못 드렸어.
놀라다	be surprised; be astonished; be shocked; be scared	verb	광분에 놀라다.
다양하다	various; diverse	adjective	각기둥의 종류는 밑면의 모양에 따라 다양하다.
울다	cry	noun	None available.
농민	farmer	noun	가난한 농민.
은행	bank	noun	None available.
지내다	live	verb	가까이 지내다.
결혼	marriage; wedding; union; matrimony	noun	몰랐어? 내년에 결혼도 한다더라.
법	law; act	noun	None available.
소설	novel	noun	None available.
예	yes sir; yes ma'am	noun	None available.
오후	afternoon	noun	오후 세 시를 가리키다.
질서	order	noun	가변적 질서.
담다	dish up	verb	가득 담다.
모이다	be gathered; be collected	adjective	가맣게 모이다.
시민	urbanite; city dweller	noun	시민들이 환승하기 편하도록 지하철역에서 가까운 곳에 버스 정류장이 들어섰다.
회장	president	noun	전 회장의 비리에 대해서 검찰이 수사를 하고 있다는 이야기를 들었니?
빠르다	fast; quick	adjective	개시가 이렇게 빠르다니 오늘은 운이 좋다.
스스로	oneself	noun	스스로 가누다.
아기	baby	noun	아기 웃음을 보면 나도 모르게 따라 웃게 돼.
아저씨	uncle	noun	새로 이사 온 아저씨는 가가호호 떡을 돌리며 이웃들과 인사를 나눴다.
옛날	past; ancient times	noun	그는 오늘 대회에서 옛날 단점들이 모두 사라진, 완벽에 가까워진 모습을 보였다.
이날	that day; this day	noun	어버이날에 나는 부모님 가슴에 꽃을 꽂아 드렸다.
제대로	right	adverb	가공할 만한 눈바람에 눈을 제대로 뜰 수조차 없었다.
달	moon	noun	보름달 아주 예뻐요.
던지다	throw	verb	가볍게 던지다.
참	truly	noun	None available.
공간	space	noun	가공적인 공간.
이곳	here	noun	이곳은 긴 강이 도시의 좌우를 갈라 지역을 구분하고 있다.
마지막	last	adjective	배우들의 연기도 좋았고 특히 여주인공의 마지막 노래가 감동적이었어.
벌이다	kick off; start	verb	가장행렬을 벌이다.
병원	hospital; clinic	noun	병원에는 무슨 일로 가니?
자세	posture; pose	noun	나는 무대 바로 앞자리에 앉아서 가극 배우의 연기를 자세히 볼 수 있었다.
강조하다	emphasize; stress	verb	특히 강조하다.
경찰	police; policing	noun	경찰은 범인을 몽둥이로 가격하여 제압했다.
맡다	undertake; take care of; take on; be in charge of; take charge of	verb	가드를 맡다.
저녁	evening	noun	그래요. 가는 길에 반찬 가게에서 저녁 반찬 좀 사 가요.
한편	same side; same group	noun	할아버지의 책장 한편에는 먼지 쌓인 고서들이 가지런히 놓여 있다.
그러면	if so	adverb	그러면 일단 너부터 노래 한 가락 뽑아 봐.
기자	reporter; journalist	noun	가극은 이태리어로 공연되었지만 연기자들의 연기와 표정을 통해 내용을 짐작할 수 있었다.
넓다	broad	adjective	가슴이 넓다.
시험	test; exam	noun	이번 시험은 통과했어?
잠	sleep	noun	너는 학생이라서 잠이 아주 중요해요.
주로	usually	noun	나는 유행가보다는 가곡이나 클래식 음악을 주로 듣지.
훨씬	by far; much; a lot	adjective	그의 도움으로 인해 이번 사업의 성공 가능성이 훨씬 더 높아졌다.
면	side; face	noun	None available.
통일	unification	noun	응. 이번 행사가 통일을 위한 가교가 되었으면 좋겠어.
건강	health; wellbeing	noun	건강을 중요하게 생각하는 승규는 술을 가까이하지 않는다.
가깝다	near; close; adjacent	adjective	절반에 가깝다.
건물	building; structure; edifice	noun	None available.
시설	facility; installation	noun	시설을 가동하다.
외국	foreign country	noun	예술가로서의 가능성을 발견한 부모는 아이를 외국으로 유학을 보내기로 했다.
밑	bottom	noun	밑으로 가라앉다.
어른	adult	noun	아이들은 새해를 맞아 가가호호를 찾아 다니며 마을 어른들께 인사를 드렸다.
주변	being around	noun	조선 시대의 가객들은 집단으로 서울 주변의 명승지를 돌아다니면서 노래를 부르곤 했다.
대신	substitute	noun	그가 가끔 들르던 서점은 사라지고 대신 그 자리에 옷 가게가 들어서 있었다.
원인	cause; reason	noun	그는 신입 사원인데도 맡은 일을 제법 잘 가누었다.
팔다	sell	verb	미안해, 저는 다 이미 팔았어.
차례	procedure; process	noun	지수는 여러 차례 가요제에서 수상을 하며 가수로 데뷔했다.
열심히	hard; diligently; zealously	adverb	승규는 매일 농구 연습을 열심히 한 결과 농구 실력이 선수에 가까워졌다.
일하다	work; labor	verb	소음이 심한 공장에서 일하다 보니 우리 공장에 가는귀먹은 직원이 많다.
재산	asset; property	noun	재산가
팀	team	noun	팀의 주장은 각각의 선수를 이어 주는 가교가 되어 팀을 하나로 만드는 역할을 한다.
부모	parents	noun	요즘 바빠서 고향에 계신 부모님께 전화도 못 드렸어.
약간	little; bit; small	adjective	네, 체온보다 약간 높은 정도로 따뜻하게 가열된 물이 좋습니다.
언어	language	noun	강세 언어.
요구하다	request; demand	verb	가담을 요구하다.
올라가다	go up; rise; ascend	verb	거슬러 올라가다.
첫	first	noun	그 작가는 첫 작품이자 마지막 작품을 하나 남기고 비명에 가 버렸다.
감독	supervision; oversight; inspection	noun	김 감독은 풍부한 상상력을 바탕으로 가공적인 영화를 한 편 제작했다.
그날	that day; the day	noun	내가 그날은 친한 친구의 집들이를 가기로 했어. 다음 주는 어때?
사실	fact	noun	사실에 가깝다.
자주	often; frequently	adverb	네가 잘 지내나 궁금하시겠다. 가급적 연락은 자주 드려.
당하다	undergo pain	verb	가격을 당하다.
삼다	adopt; have; take	verb	가보로 삼다.
약	medicine; medication; pill; drug	noun	None available.
기간	period; term	noun	식품은 모두 냉동 가공이 되어 장기간 보관이 가능했다.
담배	tobacco	noun	담배 가게.
일으키다	raise someone up; pick up; lift up	noun	가늘게 경련을 일으키다.
일단	first; in the first place; to begin with	noun	네, 일단 해 보고 말씀드리겠습니다.
할아버지	grandfather; grandpa	noun	할아버지는 늘 나에게 가계를 빛내는 훌륭한 사람이 되어야 한다고 강조하셨다.
조직	organization	noun	조직에 가담하다.
태어나다	be born	noun	건강히 태어나다.
공장	factory; plant	noun	집 앞 공장에서는 나무를 가공하여 여러 가지 가구를 만든다.
벌써	so soon	adverb	벌써 여름 방학이 가까워졌네!
즐기다	appreciate; enjoy; delight in	noun	가극을 즐기다.
환자	patient; sick person	noun	그는 뛰어난 수술 실력으로 불치병 환자를 고쳐내 불가능을 가능으로 만들 수 있다는 것을 보여 준 의사였다.
변하다	change; turn; become different	verb	가랑비로 변하다.
사고	accident	noun	사고 현장 가까이에서 피해자의 것으로 보이는 가방과 옷이 발견되었다.
아무리	no matter how	adverb	어머니는 아무리 가까운 친척이라도 함부로 돈거래를 해서는 안 된다고 하셨다.
맞추다	piece together; assemble	verb	가라오케에 맞추다.
쌀	rice	noun	쌀을 가공해서 과자를 만들기도 한대.
일반	the same; one and the same	adjective	광고에 나오는 여성들의 허리가 일반 여성보다 가느스름해 보인다.
재미있다	interesting	adjective	가감승제를 갓 배우기 시작한 학생들은 수학이 재미있다고 말했다.
가르치다	teach; instruct	verb	못 가르치다.
대화	dialogue; conversation; talk	noun	할머니는 가는귀먹은 사람처럼 다른 사람들의 대화에 관심 없이 앉아 계셨다.
막다	block; close; fend off	verb	가격 인상을 막다.
올해	this year	noun	아버지는 올해 농사에 필요한 비료를 담은 가마들을 싣고 오셨다.
형	older brother	noun	형은 용돈을 벌기 위해 아침마다 가가호호를 돌며 신문을 돌렸다.
달리	unlike	adjective	가격표가 달리다.
버리다	throw away; dump	verb	가맣게 잊어버리다.
붙이다	stick; paste	verb	가격표를 붙이다.
인물	person; man	noun	소설의 인물들은 모두 작가가 만들어 낸 가공의 인물이다.
늘	always	adjective	늘 영원히 사랑할게요.
모두	all	adjective	가가호호에 모두 전달했으니 많이 참석하겠지.
전국	the entire nation	noun	오늘은 전국에 비가 온다네.
마치다	complete; finish	verb	가판을 마치다.
전	past	noun	None available.
다만	merely	adjective	그렇지는 않습니다. 다만, 가부좌를 하면 안정적인 자세 유지에 도움이 됩니다.
도움	help	noun	그의 도움으로 인해 이번 사업의 성공 가능성이 훨씬 더 높아졌다.
가정	assumption; supposition; proposition	noun	가령 두 자녀가 있는 사 인 가정에서는 한 달 생활비로 삼백만 원 정도를 쓸 것이다.
걸다	hang	verb	가마를 걸다.
빠지다	sink down into; be thrown into	verb	가난에 빠지다.
멀다	distant; far-off	adjective	가맣게 멀다.
버스	bus	noun	시민들이 환승하기 편하도록 지하철역에서 가까운 곳에 버스 정류장이 들어섰다.
오늘날	today; these days	noun	정부와 국민들 각개의 노력이 오늘날의 국가 발전을 이루었다.
잠시	moment; short while	noun	저건 잠시 사용하던 가교를 철거하는 공사야.
농업	agriculture; farming	noun	농업이 개방화되다.
대다	be on time	noun	이 사안은 대다수 직원의 찬성으로 가결되었다.
의견	opinion	noun	잘잘못을 가려내기 위해서는 반드시 양쪽의 의견을 모두 참고해야 한다.
무대	stage	noun	무대에 선 성악가는 우아한 목소리로 가곡을 부르기 시작했다.
사진	picture; photo	noun	사진가
주장	assertion	noun	팀의 주장은 각각의 선수를 이어 주는 가교가 되어 팀을 하나로 만드는 역할을 한다.
표현하다	express; represent; manifest	verb	간결체로 표현하다.
인하다	result from; be caused by; be due to	noun	가격표를 확인하다.
이상하다	strange; unusual	adjective	이상하다. 내 가까운 친척이라고는 삼촌뿐인데.
제일	most	adjective	지수는 아침에 일어나면 제일 먼저 가벼이 스트레칭을 한다.
붙다	stick to; cling to	verb	가에 달라붙다.
아마	maybe; likely	adjective	아마 가정적 불행 때문에 사회에 불만을 가지지 않았을까 싶어.
얘기하다	tell; say; speak	verb	똑 잘라 얘기하다.
잇다	connect; link; join	verb	가계를 잇다.
조금	a little	adjective	요리사는 양념을 조금씩 가감해 가면서 음식 간을 맞췄다.
경기	game; match	noun	경기 중 얼굴에 가격을 당해 부상을 입을 수도 있기 때문이지.
목적	purpose	noun	우리는 정해 놓은 목적지도 없이 그냥 발길이 가는 대로 걸었다.
태도	attitude	noun	가부장적인 태도.
남성	male	noun	여성 운동가들은 남성 중심의 가부장제를 강력하게 비판했다.
주위	surrounding area	noun	창문을 두드리던 매서운 바람이 서서히 가라앉고 주위가 고요해졌다.
대책	measure; action	noun	대책반이 가동되다.
그만	no more	noun	그만하세요.
발생하다	occur; generate	verb	가스가 발생하다.
다리	leg	noun	다리가 다 지어졌는데 또 공사를 하네?
아무	anybody; anyone	adjective	부끄러움을 많이 타던 옆집 아이가 가수가 될 줄은 아무도 몰랐다.
어쩌다	accidentally; by chance	adjective	얼굴에 가뭇가뭇한 자국은 어쩌다 생겼니?
재료	material; ingredient	noun	밀가루는 가공성이 뛰어나 과자, 국수, 빵 등의 재료가 된다.
각각	each; every single	adjective	팀의 주장은 각각의 선수를 이어 주는 가교가 되어 팀을 하나로 만드는 역할을 한다.
결코	never	adjective	우리가 버는 돈에 비해 지금 내는 세금이 결코 가벼운 편이 아니었다.
옮기다	move; take; shift	verb	승규가 도자기를 옮기다가 떨어뜨렸는데 다행이 깨지지는 않고 표면에만 살짝 금이 갔다.
항상	always; all the time	adjective	운동을 못 하는 지수는 체육 성적이 항상 가였다.
해	sun	noun	None available.
잃다	lose	verb	가망을 잃다.
자유	freedom	noun	인간의 역사는 가만히 살펴보면 자유를 향한 투쟁이라는 생각이 든다.
책임	duty; responsibility; obligation	noun	아니, 가계를 책임져야 한다고 다른 일을 계속 하시겠대.
바뀌다	be changed; be replaced	verb	가족 제도가 바뀌다.
비슷하다	similar	adjective	용은 가공의 동물이지만 그 모습은 동양과 서양에서 모두 비슷하다.
심하다	severe; harsh	adjective	가려움증이 심하다.
경쟁	competition	noun	가격 인하 경쟁.
사랑하다	love	verb	극진히 사랑하다.
아니	no; nope; no way	noun	아니요, 이 영화는 십팔 세 이상 관람 가입니다.
여름	summer	noun	응. 다음 주면 여름 방학이야!
자라다	grow	verb	가난하게 자라다.
구체적	being concrete; being material	adjective	구체적으로 나누지는 않았지만 반씩 나눠서 하기로는 했어.
기회	chance; opportunity	noun	우리 회사는 성별과 학력 등에 대한 가름 없이 누구에게나 공평하게 기회를 주었다.
실시하다	execute; enforce; implement	verb	간담회를 실시하다.
지구	Earth	noun	응, 소행성이 지구와 충돌하는 가상도를 그린 것 같은 소설이야.
번째	beonjjae	noun	두 번째 가다.
소비자	consumer	noun	최근에는 화려한 영상으로 소비자의 구매 욕구를 자극하는 감각적인 광고가 많아졌다.
싫다	disgusting; distasteful; having no taste for	adjective	듣기 싫다. 네 말이 정말 가당찮구나.
규모	size; scale; scope	noun	전국 규모의 공모전에서 가작으로 뽑히다니 정말 대단해요.
기준	standard; basis; criterion	noun	기준으로 가늠되다.
말	speech; words	noun	말을 잘하는 사람은 상황에 맞게 말을 가감을 해서 말을 한다.
반드시	without fail; certainly	noun	잘잘못을 가려내기 위해서는 반드시 양쪽의 의견을 모두 참고해야 한다.
갖추다	be equipped; be qualified; be complete	adjective	가재도구를 갖추다.
그러니까	so	adjective	그러니까 너도 빨리 네 얘기를 하란 말이야.
받아들이다	receive; take; accept	verb	가정을 받아들이다.
값	price	noun	윗동네의 야채 가게는 신선한 야채들을 싼값에 팔아서 손님이 매우 많다.
현장	field; spot	noun	인부들은 공사 현장의 가건물에 전화를 설치했다.
건설	construction	noun	가도를 건설하다.
꺼내다	take out; carry out	verb	가방에서 책을 꺼내다.
노동자	worker; working people	noun	가난한 노동자.
언제나	always; all the time	adjective	지수는 연주하는 것을 좋아해서 악기를 언제나 가까이한다.
완전히	completely; perfectly	adverb	완전히 가다.
자동차	car; automobile	noun	자동차 팸플릿의 가격표에는 내가 듣던 가격보다 비싼 가격이 적혀 있었다.
전하다	remain; be passed on	verb	가요제에 출전하다.
존재하다	exist	verb	거리감이 존재하다.
개월	month	noun	저 아기는 이제 생후 십 개월이 되었대.
맞다	be correct	adjective	가랑비를 맞다.
별로	specially; particularly	noun	아이들이 어렸을 때는 잔손이 많이 갔는데 이제 다 커서 제가 신경 쓸 일이 별로 없어요.
어린이	children; kids	noun	어린이들은 미래에 대한 꿈을 키워 가고 있다.
정하다	decide	verb	가설을 설정하다.
한마디	one word; single word	noun	네. 어린 시절 그분이 제게 하신 한마디가 저의 운명을 가른 셈이죠.
유지하다	keep; maintain	verb	가계를 유지하다.
이데올로기	ideology	noun	가부장적 이데올로기.
공부하다	study	verb	건축학을 공부하다.
대중	crowd; party	noun	우리 부부는 가계비 부담을 줄이기 위해서 되도록 대중교통을 이용한다.
늘어나다	increase; swell	verb	가구가 늘어나다.
닦다	wipe; scrub	verb	꾸준히 갈고닦다.
만	ten thousand	noun	None available.
말씀	words	noun	네, 일단 해 보고 말씀드리겠습니다.
괜찮다	nice; fine	adjective	울음을 그치며 괜찮다고 말하는 유민이의 목소리는 차분히 가라앉아 있었다.
눈물	tear	noun	눈에 눈물이 가득하다.
각종	varieties; all kinds; all sorts	adjective	오늘은 각종 재난을 가상하여 그에 따른 대피 요령에 대해 알아보겠다.
빛	light	noun	할아버지는 늘 나에게 가계를 빛내는 훌륭한 사람이 되어야 한다고 강조하셨다.
아니	no; nope; no way	interjection	아니요, 이 영화는 십팔 세 이상 관람 가입니다.
피하다	avoid	verb	가랑비를 피하다.
거치다	be stuck; be blocked	adjective	각색을 거치다.
나아가다	move forward	verb	각처로 나아가다.
야	wow; yay	interjection	야!
지식	knowledge	noun	간접 경험으로 지식을 얻다.
여전히	just as it was before	adjective	어려서부터 단짝이었던 지수와 유민이는 여전히 사이가 각별했다.
주인	owner	noun	가게 주인.
발견하다	discover; find	verb	가능성을 발견하다.
선	line	noun	선을 넘지마.
인류	mankind; human race; humanity	noun	인류의 문화는 늘 스스로 생동성을 잃어버리고 경화될 위험이 있다.
특징	distinct characteristic; peculiarity; feature	noun	응. 국산을 가려내려면 우리나라 인삼의 특징을 잘 알고 있어야겠어.
선수	athlete; player; representative player	noun	선수들이 전부 얼굴 보호대를 하고 있네?
형식	form; formality	noun	글의 형식에만 신경을 쓰다 보니 정작 중요한 글의 내용이 간과되고 있다.
마련하다	prepare; arrange	verb	가구를 마련하다.
반	group; party	noun	None available.
발표하다	publish; release; roll out	verb	가격 인하를 발표하다.
주제	subject	noun	None available.
걸치다	hang	verb	가에 걸치다.
겪다	go through; undergo	verb	가난을 겪다.
관점	perspective; viewpoint	noun	거시적인 관점.
귀	ear	noun	가까이하며 사귀다.
기본	basics; prerequisite; essential	adjective	가산과 감산은 숫자 계산에서 가장 기본이 된다.
미터	meter	noun	가로가 이십, 세로가 삼십 센티미터예요.
사라지다	disappear; vanish; go out of sight	verb	가만히 사라지다.
어떠하다	such	adjective	행동이 어떠어떠하다.
감정	emotion; feeling; sentiment	noun	None available.
기억	memory	noun	오래 전에 애틋했던 첫사랑의 기억이 가맣게 떠올랐다.
놈	man	noun	저런 간악한 놈은 정말 큰 벌을 받아야 된다고 생각해.
인기	popularity	noun	옷을 손질하지 않고 계속 입어도 원래의 모습을 보존하는 섬유 가공법이 인기이다.
배	abdomen; belly	noun	가가호호에 배부하다.
아파트	apartment; apartment building	noun	한국에는 아파트나 빌라처럼 여러 가구가 살 수 있도록 지은 집이 많다.
가끔	sometimes	adverb	나는 가끔씩 가공적 인물인 소설의 주인공이 마치 살아 있는 사람처럼 느껴졌다.
구성	formation; organization	noun	정부가 복구를 위한 조직을 구성해서 가동에 들어갔대.
술	alcohol; liquor	noun	None available.
실제로	actually	adverb	계약서에 회사의 대표라고 적혀 있는 김 씨가 실제로는 존재하지 않는 가공인물인 것으로 밝혀졌다.
짧다	short	adjective	가락이 짧다.
고맙다	thankful; grateful	adjective	그래. 고맙다. 너희도 새해 복 많이 받아라.
관리	management	noun	겨울철 상수도 관리를 위해 비상 체제가 가동됐다.
그곳	there	pronoun	현재 간척지가 되어 버린 그곳은 예전에 바다가 펼쳐져 있었다.
보다	see; look at; notice	verb	가게를 보다.
비롯하다	start; begin	verb	마음가짐에서 비롯하다.
과연	indeed	adverb	내가 과연 이 일을 잘 해낼 수 있을지 가량이 되지 않는다.
달리다	run	verb	가격표가 달리다.
바쁘다	busy; hectic	adjective	가을걷이로 바쁘다.
이전	previous time; before	noun	나는 우주가 생기기 이전에 하늘과 땅이 가름 없이 하나였다고 믿고 있다.
인정하다	recognize; concede	verb	개인차를 인정하다.
자	ruler	noun	None available.
중앙	middle	noun	공원의 중앙에는 잔디밭이 있고 가에는 울타리가 둘러쳐져 있었다.
나쁘다	bad	adjective	가공성이 나쁘다.
불구하다	be not hindered by; disregard	verb	None available.
시키다	order	verb	가공성을 향상시키다.
게임	game	noun	우리 팀에는 게임을 이끌어 줄 적당한 가드가 없다.
국제	being international; being global	noun	국제 축구 연맹 가맹국.
그룹	group; party	noun	그룹이 결성되다.
인생	life	noun	인생이 가시밭길 같으셨던 분이셨지. 고생을 많이 하셨단다.
전통	tradition; heritage	noun	전통 가곡.
기르다	breed; grow; cultivate	verb	가축을 기르다.
잔	cup	noun	한잔 할래요?
조사하다	investigate	verb	가정 환경을 조사하다.
커다랗다	huge; enormous	adjective	커다랗다
있다	existent; existing	adjective	물가가 점점 오르고 있다.
시인	poet	noun	시인은 지난주에 자신이 쓴 시를 모아 시집을 간행했다.
언제	when; what time	pronoun	지수는 연주하는 것을 좋아해서 악기를 언제나 가까이한다.
평가	estimation	noun	비평가
내려오다	step down	verb	고갯마루에서 내려오다.
위치	location; situation	noun	가까운 위치.
줄이다	turn down; reduce; shorten	verb	가계비를 줄이다.
가격	price	noun	가격을 하다.
달라지다	become different	verb	괄목상대할 만큼 달라지다.
비다	be empty; be vacant	verb	내 동생은 너무 말라서 별명이 갈비다.
삼국	three countries	noun	국제 대회 축구 경기에서는 판정의 객관화를 위해서 모든 경기에 제삼국의 심판들이 배치된다.
손님	visitor; caller; guest	noun	가게 손님.
원하다	want; wish; hope	verb	시원하다. 갈증이 싹 가셨어.
통신	communication; correspondence	noun	통신망 가설.
확인하다	check; affirm; confirm; verify	verb	가격표를 확인하다.
모임	meeting; gathering	noun	모임에 가다.
수	number; figure	noun	None available.
웃음	smile; laughter	noun	웃음만큼 가공할 힘을 가진 게 없지.
기계	machine	noun	공장 기계를 24시간 지켜봐야 하는데 지금으로서는 야근이 가능한 사람이 없다.
모양	shape	noun	모양도 예쁘고, 네 몸매가 더 가느스름해 보여.
물질	material; substance	noun	가스 물질.
아나운서	announcer	noun	우리 언니는 800 대 1의 높은 경쟁률을 뚫고 방송국의 아나운서가 되었다.
뉴스	news	noun	요즘 뉴스를 듣고 있으면 세상에 나쁜 사람만 가득한 것 같다.
살아가다	live	verb	간신히 살아가다.
펴다	open; spread out	verb	가로 펴다.
배	abdomen; belly	noun	배가 불르다
수업	class; lesson; course	noun	모범생이던 민준이가 수업을 빠지고 노래방에 간다는 건 상상이 안 간다.
겨울	winter	noun	그 상인은 올 겨울에는 배추 가격 인상으로 김치 가격도 상승할 것 같다고 했다.
종교	religion	noun	종교의 가르침.
층	layer	noun	None available.
자연스럽다	natural; unaffected	adjective	몸짓이 부자연스럽다.
장	piece; sheet	noun	None available.
식사	meal	noun	성장기에 있는 청소년들은 가급적으로 규칙적인 식사와 운동을 해야 한다.
안다	embrace; hug; hold someone in one's arms	verb	가뿐히 안다.
이해	understanding; comprehension	noun	이해가 가다.
잊다	forget; be forgetful of	verb	감감 잊다.
제시하다	present	verb	가상도를 제시하다.
반	group; party	noun	이 안건이 통과되는 것에 반대하는 사람이 적어 표가 가에 몰릴 것으로 예상된다.
불과하다	only; just; mere	adjective	가정에 불과하다.
혹은	or; if not	adverb	기상청은 태풍으로 인해 오늘 제주도에 동풍 혹은 남동풍이 강하게 불 것으로 전망했다.
엄청나다	enormous; colossal; stupendous	adjective	사회 발전에 대한 공교육의 기여는 엄청나다.
편	direction	noun	그러게요. 가격을 확인할 수가 없으니 불편하네요.
텔레비전	TV; television	noun	어제 텔레비전에 신기한 경험을 한 사람들의 이야기가 많이 나왔어.
파악하다	understand; identify; figure out	verb	개괄적으로 파악하다.
편	direction	noun	None available.
실천	practice; action	noun	None available.
노력하다	make effort; endeavor; work hard	verb	각개가 노력하다.
보호	protection	noun	선수들이 전부 얼굴 보호대를 하고 있네?
씻다	wash	verb	개울물에 씻다.
늦다	late; later	adjective	개시가 늦다.
이웃	neighbor	noun	새로 이사 온 아저씨는 가가호호 떡을 돌리며 이웃들과 인사를 나눴다.
편지	letter	noun	어머니의 편지에는 아들을 그리워하는 마음이 가득히 실려 있었다.
공동	collaboration	noun	박 선수가 홈런 공동 선두로 올라서며 시즌 막판까지 치열한 홈런왕 다툼을 가열했다.
까닭	reason; cause	noun	나는 시험도 끝났는데 몸도 안 좋은 까닭에 겸사겸사해서 일찍 왔다.
방안	way; measure	noun	방안에는 햇살이 가득해 따뜻하고 포근했다.
센티미터	centimeter	noun	가로가 이십, 세로가 삼십 센티미터예요.
팔	arm	noun	None available.
분명하다	distinct	adjective	경계선이 분명하다.
분석	analysis	noun	분석가
소녀	girl	noun	소녀의 하얀 피부가 얼굴에 두른 가무댕댕한 천과 대조돼 더욱 하얗게 보였다.
지나가다	pass; go by	verb	가시밭길을 지나가다.
차	car; automobile; vehicle	noun	차는 어디에 주차했어요?
상품	product; goods	noun	가격 인하 상품.
설명	explanation; account	noun	승규는 영화 내용이 너무 복잡해 이해를 할 수 없었는데 누나의 설명을 듣고 그제서야 이해가 갔다.
훌륭하다	great; excellent; outstanding	adjective	가드가 훌륭하다.
관계자	interested party	noun	행사 관계자는 회원들에게 모임 참석의 가부를 물었다.
새로	newly	adverb	새로 지은 건물에는 '바로 입주 가'라고 써 있는 현수막이 걸려 있었다.
세	three	adjective	None available.
이어지다	be connected	verb	가도가 이어지다.
티브이	TV; television	noun	케이블 티브이 회사가 시청료를 인상하자 가입자가 줄었다.
봄	spring	noun	봄이 왔다.
종류	kind; sort	noun	종류에 따라 다릅니다. 여기 가격표를 한번 보시겠어요?
낮다	low	adjective	가능성이 낮다.
어깨	shoulder	noun	가녀린 어깨.
부부	couple; married couple	noun	우리 부부는 가계비 부담을 줄이기 위해서 되도록 대중교통을 이용한다.
오래	long	adverb	내 컴퓨터는 오래되어서 그런지 가끔가다가 느려진다.
요구	request; demand	noun	가담을 요구하다.
키우다	grow; raise	verb	가을보리를 키우다.
눕다	lie down; lay oneself down; lie	verb	바닥에 가로눕다.
발전하다	develop	verb	각기 발전하다.
여행	travel; trip	noun	여행가
죽음	death	noun	죽음이 가까워지다.
고통	pain	noun	병상에 누워 고통스러워하는 그의 모습이 너무나 가련했다.
공	ball	noun	None available.
어울리다	harmonize	verb	격에 어울리다.
오월	May	noun	보통 사월과 오월 사이에 교미를 하는 갈매기는 밝은 갈색의 알을 낳는다.
쉬다	rest; repose; take a rest	verb	가쁜 숨을 몰아쉬다.
알리다	inform; tell; notify	verb	개막을 알리다.
차다	be full	verb	가득 차다.
과	department; section	noun	None available.
멀리	far	adverb	가급적으로 멀리.
빼다	take out; draw; pull out	verb	가락지를 빼다.
예정	plan; expectation	noun	2년 예정이었던 아파트 공사가 벌써 마무리 단계로 가고 있다.
오빠	elder brother	noun	오빠는 이번 달 용돈을 다 써 버리고 엄마에게 용돈 가불을 하려다가 꾸지람만 들었다.
즐겁다	joyful; pleasant	adjective	응, 그래도 상상하는 것만으로도 즐겁다.
한계	limit; boundary	noun	현 상황에서 정부나 기업만이 국가 경쟁력을 높이기에는 한계가 있어 보입니다.
흔히	often; commonly; usually	adverb	그런 증상은 갱년기 초기에 흔히 볼 수 있는 증상입니다.
바탕	foundation; basis	noun	김 감독은 풍부한 상상력을 바탕으로 가공적인 영화를 한 편 제작했다.
사월	April	noun	사월의 오후, 창밖에는 봄바람이 건들거리고 있었다.
싸우다	fight; quarrel; dispute	verb	가열차게 싸우다.
예쁘다	pretty; beautiful; comely	adjective	이 반지 참 예쁘다.
갈등	conflict	noun	자본주의 사회는 빈익빈 부익부가 가속화되어 사회 계층 간의 갈등이 심해진다.
의지	will; volition	noun	의지를 가다듬다.
전문	specializing; specialty	noun	전문가
정확하다	accurate	adjective	가늠이 정확하다.
초기	beginning; start	noun	태아가 가사 상태에 빠졌을 때 초기 발견이 중요하대.
나중	next time; later	noun	나중에 가다.
맛있다	tasty; delicious	adjective	이 집 가락국수가 정말 맛있다고 내가 그랬잖아.
며칠	date	noun	며칠 전 홍수로 다리가 무너져 당분간 가교로 다니게 되었다.
쓴	bitter taste	noun	None available.
찾아오다	come visiting	verb	이렇게 훌륭한 어른이 되어 찾아오다니 대견하구나.
미	beauty	noun	None available.
사용	use; usage	noun	저건 잠시 사용하던 가교를 철거하는 공사야.
시선	eyes; gaze	noun	시선이 가다.
아무런	any; no	adjective	열흘이 가깝도록 지수한테 아무런 소식이 없어.
언론	press; journalism	noun	언론은 늘 가치 중립을 지켜야 된다고 생각합니다.
투자	investment	noun	투자가
지원	support; aid	noun	급식 지원 센터가 본격적으로 가동되는 내년부터 가능할 것 같습니다.
결정하다	decide	verb	가족회의에서 결정하다.
경영	management; business administration	noun	사실 그가 하는 공부란 것은 경영학이라기보다 경제학에 더 가까운 것이었다.
목표	target; goal	noun	우리 회원 수는 이제 구만 명으로, 목표로 한 십만 명에 가까워졌다.
성장	growth	noun	성장기에 있는 청소년들은 가급적으로 규칙적인 식사와 운동을 해야 한다.
숲	forest	noun	저쪽 숲길로 가면 훨씬 더 빨리 마을로 갈 수 있어.
없어지다	be gone; disappear	verb	가만히 없어지다.
작년	last year	noun	작년부터 몸 여기저기가 붓는다더니 한쪽 신장에 무리가 갔나 봐요.
내려가다	go down; step down; descend	verb	건너짚으며 내려가다.
미치다	go mad; lose one's mind	verb	경찰권이 미치다.
새벽	dawn	noun	아버지는 야근을 마치고 새벽 두 시 가까이가 되어서야 집에 들어오셨다.
쓰레기	rubbish; trash; garbage	noun	쓰레기에 가까워지다.
얼른	quickly; immediately; promptly	adverb	늦었으니 가볍게 대충 차려 입고 얼른 가자고.
임금	wage; pay	noun	추가로 근무를 하는 사원은 일한 시간만큼 가산 임금을 받는다.
피해	harm; damage; loss	noun	범인은 피해자의 복부를 가격을 하고 지갑을 뺏은 후 도망갔다.
한	one	adjective	민준이는 공부를 잘해서 한 번도 가를 받은 적이 없다.
무섭다	fearful; scared of	adjective	어머, 너무 무섭다. 다친 사람은 없대?
직장	workplace	noun	직장이 가깝다.
참다	endure; withstand; fight back; be patient	verb	가까스로 참다.
크기	size	noun	크기를 가늠하다.
고기	meat	noun	물고기는 몇 마리나 낚았습니까?
남기다	leave	verb	가곡집을 남기다.
서양	Occident	noun	대학에서 서양 가곡을 전공한 삼촌은 지금 성악가가 되었다.
주요	being key	noun	주요 대학이 등록금 인상 계획을 발표하면서 이에 대한 찬반 토론이 가열이 될 것으로 예상된다.
가져오다	bring	verb	혼란을 가져오다.
냄새	smell; scent; odor	noun	승규는 며칠 동안 씻지 않았는지 가까이 가니 몸에서 냄새가 났다.
부드럽다	soft; smooth	adjective	감이 부드럽다.
여기다	regard; think; count	verb	가볍게 여기다.
이	tooth	noun	None available.
공연	performance; show	noun	가극 공연.
남녀	man and woman	noun	남녀노소 가릴 것 없이.
내놓다	take out	verb	간행물을 내놓다.
속도	speed	noun	전기로 가는 차가 개발되었지만 속도가 느려 아직 많이 팔리지는 않는다.
심각하다	serious; grave	adjective	지난달에 일어난 강진의 피해가 심각하다고 들었습니다.
준비	preparation	noun	이렇게 다 준비했는데 내일 비가 와서 소풍 못 가는 거 아냐?
계속되다	continue	verb	갑론을박이 계속되다.
구월	September	noun	우리 관현악단은 삼월과 구월에 두 차례 정기 공연을 한다.
맑다	clean; clear	adjective	그지없이 맑다.
소년	boy	noun	성장기에 있는 청소년들은 가급적으로 규칙적인 식사와 운동을 해야 한다.
소식	news	noun	열흘이 가깝도록 지수한테 아무런 소식이 없어.
유월	June	noun	우리 건물은 유월부터 냉방기 가동을 시작합니다.
작용	working; function; action	noun	단순한 경제 성장의 가속화는 빈부 격차를 심화시키는 부작용을 낳을 수 있다.
허리	waist	noun	허리가 가냘프다.
골	goal	noun	None available.
공업	manufacturing industry	noun	가공업이 활발하다.
그중	among the rest; among them	noun	동생은 엄마의 가락지를 손가락에 끼고 놀다가 그중 하나를 잃어버렸다.
노인	old person; the aged; senior citizen	noun	혼자 사는 노인과 젊은이가 많아지면서 일인 가구 수가 증가하고 있다.
벌다	make; earn	verb	가욋돈을 벌다.
살리다	keep someone alive; bring someone to life; save someone's life	verb	강점을 살리다.
새	new	adjective	새로 지은 건물에는 '바로 입주 가'라고 써 있는 현수막이 걸려 있었다.
영어	English	noun	영어를 가르치다.
출신	social status	noun	출신 지역을 가름하다.
결정	decision	noun	이 안건에 대해 가인지 부인지를 결정하셨습니까?
경향	tendency; inclination	noun	간주하는 경향.
기록	record; documentation	noun	선생님은 줄자로 학생들의 가슴둘레을 측정하고 기록하였다.
나름	nareum	noun	하지만 나름의 기준을 가지고 사회를 비판하는 것도 필요하지 않을까요?
대답하다	answer; reply	verb	가볍게 대답하다.
반면	opposite; contrast; other side	noun	소금은 알갱이가 크고 거친 반면 밀가루는 알갱이가 매우 작고 곱다.
썰다	slice; cut	verb	가래떡을 썰다.
움직임	movement; motion	noun	가물가물한 움직임.
이미지	image	noun	이미지가 가녀리다.
터지다	be broken down; be pierced	verb	감탄사가 터지다.
특성	characteristic; trait; feature	noun	가족적 특성.
교장	principal	noun	교장 선생님은 강제성을 부여해 학생들이 교칙을 반드시 지키게 했다.
벗다	take off	verb	가면을 벗다.
업무	work; task; business	noun	지수는 입사한 지 한 달이 지났는데도 업무가 손에 익지가 않는다.
입시	entrance examination	noun	고기가 다 익어 가니까 불을 줄입시다.
준비하다	prepare	verb	가위를 준비하다.
청소년	teenager	noun	성장기에 있는 청소년들은 가급적으로 규칙적인 식사와 운동을 해야 한다.
응	yes	interjection	None available.
이기다	win; beat; defeat	verb	가뜬히 이기다.
찾아보다	visit	verb	고문서를 찾아보다.
취하다	be drunk; be intoxicated	verb	현금을 갈취하다.
다루다	do	verb	가뜬히 다루다.
달	moon	noun	None available.
사장	president; chief executive	noun	공사장 옆에 조립식 가건물로 식당이 지어졌다.
삼월	March	noun	삼월에 개강하다.
그렇지만	but; however; nevertheless	adverb	응, 그렇지만 강골이라서 금방 회복했어.
선배	senior; veteran	noun	선배네 회사에 입사하려면 뭘 준비해야 해요?
업체	company; business entity; enterprise	noun	제과 업체들은 내일 중으로 가격 인하를 공식적으로 발표할 것이라고 밝혔다.
키	height	noun	김 대리는 시키는 일은 잘 해내지만 어쩐지 믿음직스럽지가 못하다.
구하다	look for; obtain	verb	가감승제를 구하다.
국회	National Assembly; Congress; Parliament	noun	대통령은 국회에서 가결된 법률안을 거부할 수 있다.
그러므로	therefore; so; hence	adverb	그녀는 이해심이 많다. 그러므로 그가 저지른 사소한 실수는 용서받을 수 있을 것이다.
포함하다	include; cover; comprehend	verb	만유를 포함하다.
걱정	worry; concern; care	noun	나는 졸업이 가까워지자 취직 걱정이 되기 시작했다.
결혼하다	marry	verb	갓 결혼하다.
만약	supposing	noun	민준이는 '내가 만약 공부를 좀 더 잘했다면 좋은 대학에 갈 수 있었을 텐데' 라는 가정법을 써서 말하곤 했다.
바르다	apply; spread	verb	가볍게 바르다.
세월	time	noun	세월이 가다.
숨	breath	noun	우리는 과제를 하느라 이틀 가까이를 한숨도 못 자고 있었던 것 같다.
행사	event; occasion; ceremony	noun	지수는 어제 프린터를 구입했는데 오늘 가격 인하 행사를 해서 속상했다.
깨닫다	realize; perceive; understand	verb	깊이 깨닫다.
누나	elder sister	noun	승규는 영화 내용이 너무 복잡해 이해를 할 수 없었는데 누나의 설명을 듣고 그제서야 이해가 갔다.
신	shoes; footwear	noun	None available.
왕	king; male monarch	noun	저 드라마에 나오는 왕은 실존 인물이야?
점점	gradually	adverb	물가가 점점 오르고 있다.
질문	question	noun	가당찮은 질문.
특별	being special	noun	응, 특별 주문으로 보석이 정교하게 가공됐어.
판단	judgment; decision	noun	김 사장은 직원들의 해외 연수가 장기적으로는 회사에도 이익이 가는 일이라고 판단했다.
해결하다	solve; settle; resolve; fix	verb	가정불화를 해결하다.
거리	distance; length	noun	가공한 줄거리.
계속하다	continue	verb	거역을 계속하다.
그치다	stop	verb	가랑비가 그치다.
근처	vicinity; neighborhood	noun	아이 학교가 멀어서 학교 근처로 가족 모두 이사를 가기로 했다.
너무나	too; excessively	adverb	병상에 누워 고통스러워하는 그의 모습이 너무나 가련했다.
높이다	make higher	verb	가능성을 높이다.
부정	negation	noun	많은 시민들이 정치인들의 부정부패에 대하여 각성을 촉구하는 집회에 참여하였다.
사정	situation; circumstances	noun	사정의 가늠.
도대체	come to the point	adverb	날씨가 더워서 도대체가 입맛이 없다.
막	just	adverb	None available.
부모님	parents	noun	요즘 바빠서 고향에 계신 부모님께 전화도 못 드렸어.
수출	export	noun	수출 가계약.
계시다	live	verb	가만 계시다.
자르다	cut; sever; chop	verb	가로로 자르다.
데리다	bring with	verb	네가 어떻게 집에 들어갔느냐니 우리가 널 데리다 주었잖아.
무척	very; extremely	adverb	그녀의 손가락은 희고 가늘어 무척 아름다워 보였다.
비용	cost; expense	noun	가변 비용.
비행기	plane; airplane	noun	항공사 사정으로 동남아시아로 가는 비행기가 모두 취소되었다.
옳다	right; righteous	adjective	너 누구 말이 옳다고 생각하니?
원래	origin	noun	옷을 손질하지 않고 계속 입어도 원래의 모습을 보존하는 섬유 가공법이 인기이다.
처리	handling	noun	과반수의 의원들이 찬성한 안건들은 곧바로 가결로 처리되었다.
최초	being the first; being original	noun	최초로 개발되다.
꼴	shape; look; sight	noun	꼴이 가관이다.
놀이	play; entertainment	noun	물놀이를 하다가 가랑이가 다 젖었다.
뿌리	root	noun	뿌리 깊은 가계.
수입	earning; income	noun	수입 가구재.
초	beginning	noun	None available.
그리하여	that's how	adverb	그는 어릴 때부터 책을 많이 읽었고 그리하여 많은 지식을 쌓을 수 있었다.
낮	day; daytime	noun	None available.
일찍	early	adverb	오늘 일찍 올 수 있어?
직원	employee	noun	직원은 제품의 품질이 향상되었기 때문에 가격 인상이 정당하다고 말했다.
찍다	stamp	verb	가로축에 점을 찍다.
가볍다	light	adjective	표정이 가볍다.
내부	inside; interior	noun	보일러가 가동하면 곧 공장 내부의 온도가 높아질 것이다.
다소	somewhat	adverb	약을 먹고 푹 쉬니 감기 증세가 다소 가벼워진 것 같다.
상대	facing each other	noun	그는 상대 선수에게 가격을 당해 큰 부상을 입을 뻔했다.
오전	morning	noun	오늘 오전에 일식이 일어난다면서요?
피부	skin	noun	피부를 가꾸다.
가게	shop; store	noun	가게에 오다.
가득	full	adverb	반찬을 이렇게 가득 담으니까 뚜껑이 안 닫히지.
그저	just; same	adverb	네, 아무것도 안 보이고 그저 남편의 목소리만 가물가물했어요.
도	degree	noun	None available.
벽	wall	noun	이 식당은 벽마다 가격표를 크게 붙여 놓아서 주문하기가 쉽다.
장군	general; admiral	noun	박 장군은 군사 기밀을 누설하여 간첩죄의 혐의를 받았다.
무역	trade; commerce	noun	세계 무역 기구 가맹국.
부담	burden; obligation	noun	아이들의 사교육비가 가계에 큰 부담을 주는 것으로 나타났다.
약속	promise; appointment; pledge	noun	둘은 가까운 장래에 함께 유학을 가기로 약속했다.
인사	greetings	noun	아이들은 새해를 맞아 가가호호를 찾아 다니며 마을 어른들께 인사를 드렸다.
줄	rope; string	noun	None available.
쳐다보다	look up	verb	강렬히 쳐다보다.
충분히	enough; sufficiently; fully	adverb	가늘게 부는 바람이었지만 이마에 흐르는 땀을 식히기에 충분히 시원했다.
신체	body	noun	가부좌로 앉으면 자세를 바르게 할 수 있고 신체의 불균형을 예방할 수 있다.
에너지	energy; power	noun	겨울에는 난방으로 인해 에너지 소비량이 가파르게 상승한다.
위원	member	noun	위원회가 가동되다.
정리하다	organize	verb	가계부를 정리하다.
집안	house; home	noun	우리 가계는 유서 깊은 학자 집안이다.
배경	background	noun	김 작가는 여행을 하면서 소설의 배경이 되는 가공적 세계를 구상한다.
죽이다	kill	verb	양복을 몇십 년 동안 입었더니 거죽이 다 해져 버렸다.
단순하다	simple	adjective	구질이 단순하다.
반대	opposite; contrary	noun	이 안건이 통과되는 것에 반대하는 사람이 적어 표가 가에 몰릴 것으로 예상된다.
법칙	rule; law; regulation	noun	고정불변의 법칙.
빠지다	sink down into; be thrown into	verb	가난에 빠지다.
소금	salt	noun	먼저 배를 가르고 소금을 조금 넣으세요.
오염	pollution; contamination	noun	가속화되는 환경 오염을 막기 위해 우리가 할 수 있는 일은 무엇이 있을까요?
자전거	bicycle	noun	내리막길에서 가속이 붙은 자전거는 더욱 빨리 달려 내려갔다.
참여하다	participate; get involved	verb	가급적 참여하다.
탓	reason; cause	noun	장마가 길어진 탓에 채소와 과일 가격이 대체로 올랐다.
푸르다	blue; green	adjective	색이 검푸르다.
그래	okay; sure	interjection	그래요. 가는 길에 반찬 가게에서 저녁 반찬 좀 사 가요.
목	neck	noun	None available.
발표	announcement; presentation; release; roll out	noun	가격 인하를 발표하다.
범죄	crime	noun	가공할 만한 범죄.
위	top; higher part	noun	형은 용돈을 벌기 위해 아침마다 가가호호를 돌며 신문을 돌렸다.
흔들다	wave; sway; flap; wag; shake	verb	가만가만 흔들다.
기초	base; foundation	noun	축구 선수가 되려면 우선 기초 체력부터 강화해야 해.
논리	logic; reasoning	noun	논리력 강화.
뽑다	pull; pick; pluck	verb	가늘게 면을 뽑다.
피우다	make bloom; open up	verb	가지가지로 말썽을 피우다.
감각	sense; sensation; feeling	noun	감각이 좀 둔한가 봐.
미리	in advance; ahead of time	adverb	우리 마을에서는 가뭄에 대비해서 저수지에 물을 미리 가두어 두곤 한다.
부족하다	insufficient	adjective	감별력이 부족하다.
저희	our	pronoun	어머니, 아버지, 저희들 가르치시느라고 고생 많으셨죠?
진행되다	progress	verb	감원이 진행되다.
교통	transportation; traffic	noun	우리 부부는 가계비 부담을 줄이기 위해서 되도록 대중교통을 이용한다.
기구	utensil; tool; implement	noun	알루미늄은 열에 잘 견디고 가공성이 우수해 여러 기구의 재료로 쓰인다.
법	law; act	noun	None available.
오랜	long	adjective	너무 오랜만에 동창회를 간 탓인지 전부 모르는 얼굴뿐이었다.
젊은이	young man; young woman	noun	혼자 사는 노인과 젊은이가 많아지면서 일인 가구 수가 증가하고 있다.
후보	candidate; candidacy	noun	후보들은 가가호호 돌아다니며 선거 운동을 벌였다.
거리	distance; length	noun	가공한 줄거리.
과제	task	noun	우리는 과제를 하느라 이틀 가까이를 한숨도 못 자고 있었던 것 같다.
근거	base; stronghold	noun	가슴이 두근거리다.
기록하다	record; document	verb	경과를 기록하다.
다가오다	approach; come near	verb	가까이 다가오다.
불다	blow	verb	가볍게 바람이 불다.
시각	viewpoint; perspective	noun	감독은 이번 영화에 시각적인 요소를 가미했다.
이끌다	bring; take	verb	가요계를 이끌다.
종합	being aggregate; being combined	noun	나는 종합 병원에 가지 않고 동네 개업의를 찾아갔다.
한글	Hangeul	noun	한글 가로쓰기.
가을	fall	noun	황금색 가을 논의 풍경이 가관이어서 우리는 모두 입을 다물지 못했다.
개발하다	develop; exploit	verb	가공법을 개발하다.
내일	days to come; future	noun	제과 업체들은 내일 중으로 가격 인하를 공식적으로 발표할 것이라고 밝혔다.
매일	everyday	noun	그 가겟집은 정갈하고 푸짐하게 차려진 음식으로 매일 손님이 붐빈다.
손가락	finger	noun	가녀린 손가락.
수단	means; method	noun	가능한 수단.
자	ruler	noun	None available.
자유롭다	free	adjective	기동이 자유롭다.
적극적	being active	noun	경찰의 수사에 적극적으로 협조한 죄인의 형벌이 감면되었다.
판매	sale; selling	noun	가공식품을 판매하다.
형성	formation; building; development	noun	아이들의 성격 형성에는 가정적 환경이 큰 영향을 미친다.
기울이다	lean; tilt	verb	가만히 귀를 기울이다.
길이	length; distance	noun	응, 침대를 사러 가구점에 다녀오는 길이야.
장면	scene	noun	텔레비전에서 끔찍한 장면이 나오자 나는 아이의 눈을 가렸다.
점차	being gradual	noun	점차 가속화되다.
톤	ton	noun	None available.
관련되다	be related	verb	밀접하게 관련되다.
급	rank; position	noun	None available.
나머지	the rest; remainder	noun	이 아이는 배가 너무 고픈 나머지 절도를 저질렀는데 처벌이 무거울까요?
날씨	weather	noun	날씨가 더워서 도대체가 입맛이 없다.
더불다	do together	verb	None available.
의사	doctor; physician	noun	저는 커서 의사가 되고 싶어요.
개방	opening; opening to the public	noun	개방적인 가정 환경.
건강하다	healthy; strong	adjective	정신이 건강하다.
미래	future; days ahead	noun	과거와 미래를 왔다 갔다 하는 건 가공적인 세상에서나 가능한 이야기겠지?
앞서	before; earlier	adverb	우리 군은 전투에 앞서 무기를 정비하고 대열을 가다듬었다.
여러분	everyone; everybody	pronoun	여러분 가운데 누가 다음 시간에 발표를 할 건가요?
왜냐하면	because; since; by reason of	adverb	왜냐하면 니코틴은 마약만큼이나 중독성이 강하기 때문이야.
인구	population	noun	도시로 인구가 집중되면서 도시 가구 수가 농촌 가구 수의 일곱 배를 넘어섰다.
기대하다	expect; anticipate	verb	간절히 기대하다.
네	yes; yes sir; yes ma'am	interjection	None available.
도착하다	arrive; reach	verb	강어귀에 도착하다.
병	disease	noun	None available.
소프트웨어	software	noun	이 소프트웨어를 이용하면 검색한 자료를 오름차순 또는 내림차순으로 재배열시킬 수 있다.
흘리다	spill	verb	구슬땀을 흘리다.
반응	reaction; response	noun	엄마한테 반에서 일 등을 했다고 말씀드렸는데 별 반응이 없으셨어요.
주인공	main character	noun	나는 가끔씩 가공적 인물인 소설의 주인공이 마치 살아 있는 사람처럼 느껴졌다.
당연하다	natural; justifiable; fair	adjective	나는 나를 낳아 주신 부모님을 공경하고 섬기는 것은 당연하다고 생각한다.
비판	criticism; critical judgment; rebuke	noun	여성 운동가들은 남성 중심의 가부장제를 강력하게 비판했다.
빌리다	borrow; rent	verb	거상에게 돈을 빌리다.
세대	generation	noun	우리 동네에 몇 세대가 거주하고 있나요?
축구	soccer	noun	운동장에는 축구, 달리기, 배드민턴 등을 즐기는 시민으로 가득했다.
형님	older brother	noun	돌아가신 형님께 하나뿐인 딸인데 당연히 내가 거두어야지.
놓이다	be relieved	verb	철조망이 가로놓이다.
당장	right now	noun	우리가 제시한 안이 가결만 된다면 내일부터 당장 일이 시작된다.
무렵	around; about	noun	우리는 해질 무렵 감색의 저녁노을을 감상했다.
밝다	light; brilliant; luminous	adjective	가로등이 밝다.
사물	object; thing	noun	우선 카메라와 사물의 각도를 잘 잡아 주는 것이 중요합니다.
일반적	being general; being popular; being universal	noun	한자를 쓸 때 일반적으로 세로획보다 가로획을 먼저 쓴다.
장소	place; venue; space	noun	가령 결혼식이나 상갓집에 갈 때에는 장소와 상황에 맞게 옷을 입어야 한다.
곱다	beautiful	adjective	가루가 곱다.
바닥	bottom; floor	noun	이 책들은 왜 바닥에 쌓아 놨니?
새끼	cub	noun	어미를 잃은 새끼 고양이는 가녀린 울음소리를 냈다.
생각되다	look; appear	verb	괴물로 생각되다.
서비스	service	noun	냉각 장치가 잘 가동되지 않나 봐. 서비스를 불러야겠다.
선택하다	choose; make a choice; select	verb	개체를 선택하다.
심다	plant	verb	가로수를 심다.
적다	little; a little	adjective	가계부를 적다.
코	nose	noun	왜 코피가 났어?
간단하다	simple	adjective	이유가 간단하다.
고등학교	high school	noun	나와 내 고등학교 동창들은 일 년에 한 번씩 동창회를 가진다.
공개	announcement; pronouncement	noun	가이드라인을 공개하다.
교실	classroom	noun	선생님 목소리는 너무 가늘어서 교실 뒤에서는 잘 들리지 않는다.
스스로	oneself	noun	스스로 가누다.
견디다	bear; stand; endure	verb	가까스로 견디다.
기사	driver	noun	전기 가설 기사는 마을의 전신주에서 새로 지은 집까지 전기를 설치했다.
막히다	be blocked; be closed; be clogged	verb	눈앞이 가로막히다.
매체	medium	noun	독재 정권이 들어선 이후 모든 언론 매체가 검열을 당하고 있다.
별	star	noun	None available.
복잡하다	complex; complicated	adjective	거리가 복잡하다.
뿌리다	fall; blow and fall	verb	가루약을 뿌리다.
영역	territory; domain	noun	영역을 가르다.
체험	experience	noun	가상 체험.
구속	restriction; restraint	noun	경찰은 그의 죄질이 가볍다는 것을 인정해 그를 구속하지 않았다.
어쩌면	maybe; perhaps; possibly	adverb	우리 길을 잃은 것 같아. 어쩌면 좋지?
극복하다	overcome	verb	가난을 극복하다.
불법	illegality; unlawfulness	noun	불법 낙태 수술을 뿌리 뽑기 위해서는 어떻게 해야 할까요?
비밀	secret; covertness	noun	지수와 나는 서로의 비밀을 모두 알 정도로 가까운 사이이다.
색	color; tint; hue	noun	None available.
쓰이다	be used; be made use of	verb	가구재로 쓰이다.
일정하다	uniform	adjective	땀이 일정하다.
다지다	mince; chop	verb	가늘게 다지다.
아까	a moment ago	noun	선글라스를 낀 남자가 아까부터 아이를 쳐다본다.
알맞다	appropriate; proper; suitable	adjective	이곳의 기후는 벼농사를 짓기에 알맞다.
이념	ideology	noun	양국의 이념적 대립이 외교 분쟁을 격화시키고 있어 파장이 예상된다.
희다	white	adjective	눈으로 덮인 산은 희다 못해 눈이 시리다.
가리키다	point; gesture; indicate	verb	백 도를 가리키다.
모시다	serve; attend; wait on	verb	강연자를 모시다.
발달	development; growth	noun	현대 사회로 오면서 건조, 냉동, 조림 등 다양한 식품 가공법이 발달했다.
수많다	numerous; abundant	adjective	None available.
치르다	pay; settle	verb	간소하게 예식을 치르다.
평화	peace	noun	유엔에 가입된 국가들은 국제 평화를 위해 협력할 의무가 있다.
공사	construction	noun	인부들은 공사 현장의 가건물에 전화를 설치했다.
박사	doctoral degree; Ph.D.	noun	김 교수는 부부 관계와 가정 환경이라는 주제로 논문을 써 가정학 박사가 되었다.
성	surname; family name	noun	None available.
전문가	expert; specialist	noun	None available.
단지	just	adverb	그녀는 자신의 눈물이 그에게는 단지 값싼 눈물로 보일 것이라는 사실을 알고 있었다.
말씀하다	say; speak	verb	수업에 대해 말씀하다.
무용	dance	noun	None available.
불리다	soak; sodden	verb	갈비라고 불리다.
싸움	fight; struggle	noun	싸움을 가로맡다.
자꾸	frequently; repeatedly; again and again	adverb	저녁 식사 때 이모가 해 오신 반찬이 맛있어서 자꾸 그쪽으로만 손이 갔다.
차리다	set the table	verb	가게를 차리다.
해외	foreign country; overseas	noun	김 사장은 직원들의 해외 연수가 장기적으로는 회사에도 이익이 가는 일이라고 판단했다.
그리	that way; there	adverb	None available.
문화재	cultural asset; cultural property	noun	우리나라는 식민지 시대에 문화재 강탈을 수없이 당했습니다.
미소	smile	noun	가느다란 미소.
보통	being ordinary; being average	noun	보통 최신 가요를 틀어 주더라. 난 요즘 노래 안 좋아해서 거기 안 가.
식당	cafeteria; restaurant	noun	None available.
의미하다	mean; signify; imply	verb	변화율을 의미하다.
이래	since	noun	민준이 이름이 본명이 아니라 가명이래.
체육	exercise; physical activity	noun	운동을 못 하는 지수는 체육 성적이 항상 가였다.
구성되다	be formed; be organized	verb	각층으로 구성되다.
독특하다	unique	adjective	냄새가 독특하다.
사례	example; case; precedent	noun	어려운 사정을 헤아려 처벌을 가벼이 한 사례가 있으니 지켜봅시다.
소개하다	mediate	verb	각시를 소개하다.
잘되다	go well; work well; work out	verb	가정 교육이 잘되다.
추진하다	propel; push; drive	verb	감원을 추진하다.
칠월	July	noun	작년 칠월에는 비가 많이 왔어.
틀	mold	noun	None available.
평균	average; mean	noun	매달 평균 열 대의 자동차를 팔았으니 다음 달이면 내가 목표한 판매량을 채울 것으로 가늠된다.
훈련	training; drill; discipline	noun	맞아. 김 감독님이 승규의 가능성을 믿고 어릴 때부터 훈련시키셨으니까.
흐름	flow; stream; passage	noun	흐름을 가로막다.
십이월	December	noun	십이월은 사람들로 하여금 한 해 동안의 궤적을 뒤돌아보면서 삶의 의미를 생각하도록 하는 성찰의 달이다.
쌓이다	be piled up; be heaped	verb	강바닥에 쌓이다.
이익	benefit; profit; interest	noun	김 사장은 직원들의 해외 연수가 장기적으로는 회사에도 이익이 가는 일이라고 판단했다.
쥐다	clench	verb	찻잔을 감싸쥐다.
컵	cup	noun	나는 유리 가공업이 발달한 관광지에서 유리로 만든 컵과 공예품을 사 왔다.
게다가	additionally	adverb	네, 게다가 그중 상당수를 아직 돌려받지 못한 실정입니다.
끓이다	boil	verb	갈비탕을 끓이다.
논문	dissertation; paper; thesis	noun	장 교수는 논문에서 설문 조사 결과를 통해 자신의 가설을 뒷받침했다.
멈추다	stop doing; quit	verb	가래질을 멈추다.
사용되다	be used	verb	공공용지가 사용되다.
오랫동안	for ages	noun	시신을 가매장 상태로 오랫동안 방치하면 안 좋으니까 빨리 묏자리를 찾자.
위기	crisis; emergency	noun	그는 봄을 맞아 집안 분위기를 바꾸려고 가구를 달리 배치하였다.
정당	party	noun	직원은 제품의 품질이 향상되었기 때문에 가격 인상이 정당하다고 말했다.
종이	paper	noun	선생님, 종이로 가려진 이 부분은 뭐예요?
찾아가다	go visiting	verb	가가호호 찾아가다.
폭력	violence	noun	응. 학교 폭력이라면 단순 가담도 처벌 대상이 된대.
혹시	by any chance	adverb	혹시 지수한테 무슨 일이 생긴 게 아닐까?
늘다	be extended	verb	허리가 가늘다.
양	quantity; amount	noun	아니, 양은 두 개 있지만 가는 없어.
절차	procedure	noun	가입 절차.
계시다	live	verb	가만 계시다.
공기	air	noun	그래도 요즘에는 가로수를 많이 심어서 공기가 많이 좋아진 것 같아.
닿다	attach; touch	verb	가슴에 와 닿다.
속하다	belong	verb	가무단에 속하다.
올림픽	Olympics	noun	올림픽 개회식 때 남북한이 함께 입장을 한다며?
이외	the others; being other than	noun	아이에게 용돈 이외의 가욋돈이 생기면 부모인 내가 대신 관리한다.
재미	fun; interest	noun	가감승제를 갓 배우기 시작한 학생들은 수학이 재미있다고 말했다.
제공하다	provide; offer	verb	경품을 제공하다.
증가하다	grow; rise	verb	가계비가 증가하다.
기대	expectation	noun	한 가닥의 기대.
식물	plant	noun	음식물을 오래 두었더니 초파리들이 가맣게 꼬였다.
옛	old; ancient	adjective	None available.
외치다	cry out; shout	verb	가열차게 외치다.
적어도	at least	adverb	새로 시작하는 국가사업은 적어도 일만 명의 고용을 창출할 것으로 예상된다.
편하다	comfortable; easy; peaceful	adjective	가락엿은 길쭉하기 때문에 작은 조각으로 부러뜨려야 먹기가 편하다.
평	criticism; comment; review	noun	None available.
권리	right; authority; power	noun	부자나 가난뱅이나 할 것 없이 모든 사람은 행복할 권리가 있다.
끝내다	complete; finish	verb	가까스로 끝내다.
대답	answer; reply	noun	가는귀먹었어? 왜 대답을 안 해?
시작	start; beginning	noun	곧 표결을 시작하오니 가인지 부인지 여부를 정해 주시기 바랍니다.
어려움	difficulties; trouble; hardship	noun	어려움이 가로놓이다.
일주일	one week; a week	noun	엄마가 일주일 동안 집을 비우신 동안 집안은 엄마의 손이 가지 않아 엉망이 되었다.
자원	resource; material	noun	자원봉사자들이 공원을 깨끗하게 가꾸려고 노력하고 있다.
춤	dance	noun	None available.
넘기다	pass; miss; exceed	verb	가볍게 보아 넘기다.
물체	object	noun	그래프의 가로축에는 물체의 속돗값이 표시되었다.
분명히	clearly	adverb	가만있어, 분명히 어디서 본 얼굴인데 누구지?
시위	demonstration; protest	noun	시위 가담.
아무것	anything	noun	아버지는 아무 것도 없던 마당을 화단으로 가꾸셨다.
온	all; entire	adjective	None available.
젖다	get wet	verb	가랑이가 젖다.
제외하다	exclude	verb	국가 대표에서 제외하다.
최대	the largest; the most; maximum	noun	가급적이면 최대한.
평소	ordinary times	noun	평소에 말이 많은 유민이가 대화에 참여하지 않고 가만있는 게 이상했다.
견해	view; opinion; viewpoint	noun	가난으로 고생하면서도 항상 밝게 살아가는 모습은 참 대견해.
깨끗하다	clean	adjective	객실이 깨끗하다.
농사	farming	noun	아니. 김 사장님은 가난뱅이 농사꾼의 아들에서 지금 그렇게 성공하신 거래.
안정	stability; equilibrium	noun	주식이나 펀드는 가변성이 심하기 때문에 안정적으로 수익을 얻기는 힘들어요.
어둠	darkness; dark	noun	어둠에 가려지다.
어둡다	dark; dim	adjective	가는귀가 어둡다.
어쨌든	anyway; anyhow; at any rate	adverb	어쨌든 모든 일은 끝났으니 일단은 쉬게나.
주택	house	noun	None available.
고장	defect; something wrong	noun	상대방 전화기가 고장 났는지 아무리 걸어도 신호가 가지 않는다.
관련하다	be related	verb	밀접히 관련하다.
눈길	glance	noun	차들이 눈길을 천천히 가는 바람에 승규는 한 시간째 버스 안에 있다.
물어보다	ask; inquire; interrogate	verb	고문관에게 물어보다.
미안하다	regrettable; sorry	adjective	나는 아내에게 항상 고맙고 미안하다.
밀다	push	verb	강판에 밀다.
스트레스	stress	noun	요즘 스트레스가 심해서 자주 가위눌리거든.
음	mhm; uh-huh	interjection	None available.
인사	greetings	noun	아이들은 새해를 맞아 가가호호를 찾아 다니며 마을 어른들께 인사를 드렸다.
주어지다	be given; be endowed	verb	명제가 주어지다.
고려하다	consider	verb	개인차를 고려하다.
과일	fruit	noun	과일 가게.
널리	widely; extensively	adverb	슈베르트가 작곡한 가곡은 지금까지도 사람들에게 널리 사랑받는다.
농촌	farming village; rural area	noun	도시로 인구가 집중되면서 도시 가구 수가 농촌 가구 수의 일곱 배를 넘어섰다.
올라오다	come up; rise; ascend	verb	구역질이 올라오다.
챙기다	pack	verb	가방을 챙기다.
고르다	choose; select	verb	가전제품을 고르다.
바르다	apply; spread	verb	가볍게 바르다.
벌어지다	widen	verb	경기 내내 양 팀 사이에 팽팽한 접전이 벌어지다가 결국 마지막 10분이 오늘 경기의 승부를 갈랐다.
소재	material	noun	응, 신소재 개발 실험에서 발생한 유해한 가스 때문에 죽었다는 소문이 있어.
전망	view	noun	가시화될 전망.
포기하다	give up	verb	거부권을 포기하다.
형성되다	be formed; be built; be developed	verb	간석지가 형성되다.
고치다	repair; mend	verb	가분수를 대분수로 고치다.
그림자	shadow; silhouette	noun	그림자는 정오에 가까워질수록 짧아진다.
눈	eye	noun	가공할 만한 눈바람에 눈을 제대로 뜰 수조차 없었다.
다하다	exhaust; use up	verb	가운이 다하다.
마침내	finally; after all	adverb	끊임없는 도전이 각고의 결실을 맺어 마침내 그가 시험에 붙었다.
비교하다	compare	verb	값을 비교하다.
시월	October	noun	아직 시월 말인데 갑자기 날씨가 추워져 사람들이 벌써 겨울옷을 입고 있다.
커지다	get bigger; grow; increase	verb	가슴이 커지다.
한쪽	one side; one part	noun	작년부터 몸 여기저기가 붓는다더니 한쪽 신장에 무리가 갔나 봐요.
검사	examination; inspection	noun	이 검사는 지방에서 근무한 지 5년 만에 근무지가 바뀌어 서울 법원으로 가게 되었다.
결론	conclusion	noun	사람들의 의견이 저마다 가지각색이라서 아직 결론을 내지 못했습니다.
맡기다	assign; entrust	verb	가축병원에 맡기다.
박물관	museum	noun	민속 박물관에서 꽃으로 꾸민 예쁜 가마 한 채를 발견했다.
소문	rumor; hearsay	noun	소문난 가게.
싣다	load; lade; freight	verb	가득 싣다.
쌓다	pile; heap	verb	가득가득 쌓다.
어서	quickly; without hesitation; without delay	adverb	감기에 걸렸는데 약만 먹어서는 낫지가 않아서요.
자녀	child	noun	가령 두 자녀가 있는 사 인 가정에서는 한 달 생활비로 삼백만 원 정도를 쓸 것이다.
제목	title	noun	내용은 기억이 나는데 제목이 가물가물하네.
짓	act	noun	None available.
판결	decision; judgment	noun	가정 법원에서 판결하다.
팔월	August	noun	팔월도 다 지나갔으니 곧 가을이 오려나 봐.
하얗다	white	adjective	뽀드득뽀드득 소리를 내며 발밑에 밟히는 눈이 눈이 부실 정도로 하얗다.
희망	hope	noun	한 가닥의 희망.
가방	bag	noun	이 지역은 가죽이 유명해서 구두, 가방, 가죽 장갑 등의 가공품이 많이 팔린다.
군대	military; troops	noun	국회가 군대 파병 안을 가결하여 다음 달에 우리 군대가 파병될 것이다.
그만큼	that much	noun	와! 그만큼 인터넷 쇼핑이 많이 발전했구나!
무어	what	pronoun	걔가 무어 할 줄 아는 게 있어야지.
비로소	not till then	adverb	연극과 뮤지컬의 관람 요금이 내려가면서 공연 예술이 비로소 개화하고 있다.
상대방	counterpart; the other person	noun	상대방 전화기가 고장 났는지 아무리 걸어도 신호가 가지 않는다.
서구	Occident	noun	서구 문물을 배우고 돌아온 지식인들은 서양의 문물을 배워 나라를 튼튼히 해야 한다며 개화파를 형성하였다.
소유	ownership; possession	noun	소유권이 가다.
시골	rural area; countryside	noun	할아버지, 시골에 내려가시게요?
실수	mistake; blunder	noun	성격이 꼼꼼한 지수도 가끔가다 실수를 한다.
잘못되다	go wrong	verb	내용이 잘못되다.
치료	cure; treatment	noun	가려움증을 치료하다.
폭	width; breadth	noun	None available.
호	ho	noun	None available.
내밀다	protrude; stick out; extend	verb	아이가 뜨거운 연기 쪽으로 손을 내밀다가 금방 거둬들였다.
맞다	be correct	verb	가랑비를 맞다.
부문	division; section	noun	박 감독의 영화가 작년에 이어 올해도 영화제의 공식 경쟁 부문에 진출해 수상하는 쾌거를 이뤘다.
시리즈	series	noun	시리즈로 제작되는 영화에는 각 편마다 대개 부제가 달린다.
임신	pregnancy	noun	맞아. 그러니 임신을 했을 때는 정기적인 검진을 받아야 해.
잡히다	be arrested; be held; be caught	verb	감상주의에 사로잡히다.
규정	regulation; rule	noun	개념을 규정하다.
그램	gram	noun	저울의 눈금이 오백 그램을 가리키자 쌀집 주인은 쌀을 담던 손을 멈추었다.
밭	field	noun	None available.
분석하다	analyze	verb	경제 지표를 분석하다.
식구	family member	noun	그래서 저는 식구들의 휴대 전화 요금부터 줄여 보려고요.
아예	from the outset	adverb	아예 논을 갈아엎고 다시 농사를 짓는 게 낫겠어요.
어찌	why	adverb	올 겨울 유행하는 감기는 어찌나 독한지 한 번 걸리면 이 주 이상을 간다.
울리다	make cry; move someone to tears	verb	가득 울리다.
작용하다	act; function; work	verb	걸림돌로 작용하다.
확실하다	certain; sure; confident; definite	adjective	거의 확실하다.
개선	improvement	noun	신제품 개발을 통해 회사 이미지 개선이라는 간접적 효과도 기대할 수 있다.
그릇	bowl; dish; container	noun	발굴되는 그릇의 제작 시기는 모양과 재료로 가늠된다.
글자	letter; character	noun	시험 기간이라 무리해서 그런지 책의 작은 글자들이 가물가물한다.
바람직하다	desirable	adjective	환경 문제는 개별 국가의 독자적 노력보다 국제 사회가 함께 해결하는 것이 바람직하다.
연구하다	research; study	verb	가공법을 연구하다.
착하다	kind; generous	adjective	강박적으로 집착하다.
개	dog	noun	아니, 양은 두 개 있지만 가는 없어.
부동산	property; real estate	noun	부동산 감정.
신화	myth; mythology	noun	신화의 가공인물.
양	quantity; amount	noun	아니, 양은 두 개 있지만 가는 없어.
점	point; dot	noun	물가가 점점 오르고 있다.
직업	occupation; job	noun	직업을 가지다.
거두다	harvest; reap	verb	가입비를 거두다.
방학	vacation	noun	방학이 가까워지다.
범위	scope; range	noun	가시광선의 범위.
조상	ancestor	noun	조상의 가호.
철학	philosophy	noun	None available.
검다	black; dark	adjective	속이 검다.
곁	vicinity; side	noun	None available.
근본적	being fundamental; being basic	noun	근본적인 개선책.
너희	you	pronoun	None available.
대형	large size; being large	noun	대형 가방.
문제점	problem; drawback	noun	문제점으로 가정되다.
본격적	being in full swing	noun	급식 지원 센터가 본격적으로 가동되는 내년부터 가능할 것 같습니다.
불가능하다	impossible	adjective	그러게요. 철도와 항로 등의 교통 기관도 모두 이용이 불가능하다고 하네요.
충격	impact	noun	충격을 가누다.
퍼지다	spread out; flare out	verb	가늘게 울려 퍼지다.
금방	moment ago	adverb	민준이는 금방이라도 일어날 듯이 의자 가에 엉덩이만 살짝 걸치고 앉았다.
남쪽	south; southern area	noun	고속 도로를 타고 남쪽으로 달려 부산에 가까워지자 우리들은 설레기 시작했다.
누르다	press; push	verb	건반을 누르다.
미술	art; fine art	noun	None available.
백성	subjects; populace; the people	noun	가엾은 백성.
상당히	fairly; pretty	adverb	최근 유통업계의 경쟁이 상당히 치열해진 것으로 보입니다.
색깔	color; hue; tint	noun	가무칙칙한 색깔.
요리	cooking	noun	요리사는 양념을 조금씩 가감해 가면서 음식 간을 맞췄다.
유명하다	famous; popular	adjective	이 음식점은 갈비찜이 맛있기로 유명하다.
자네	you	pronoun	자네는 쓰는 책마다 베스트셀러가 되니 같은 작가로서 부럽구만.
기	energy	noun	None available.
꽤	quite; fairly	adverb	병원 입원비 내려면 돈이 꽤 들겠어요.
외국인	foreigner	noun	삼촌은 한국 전통문화를 소개해 주는 행사에서 가마를 메고 외국인들을 태웠다.
한참	long time; being a while	noun	네, 정신을 가누기가 힘들어 한참을 멍하니 있었어요.
군사	being military	noun	박 장군은 군사 기밀을 누설하여 간첩죄의 혐의를 받았다.
끊다	cut	verb	감을 끊다.
넘어가다	fall down; be brought down	verb	간드러지게 넘어가다.
담기다	be dished up	verb	가득 담기다.
마당	garden; yard	noun	마당에는 왜 나가려고?
부인	wife	noun	이 안건에 대해 가인지 부인지를 결정하셨습니까?
서두르다	hurry; rush	verb	가급적 서두르다.
지적	indication	noun	지적 갈증.
짝	couple; pair; piece; partner; mate	noun	None available.
참으로	truly; sincerely	adverb	참으로 가상하다.
충분하다	sufficient; enough	adjective	이 사건은 증거가 불충분하다는 이유로 소송이 각하되었다.
기쁘다	happy; glad	adjective	크리스마스 전날, 교회에는 '기쁘다 구주 오셨네'와 같은 찬송가가 울려 퍼졌다.
숙제	homework	noun	수학 선생님께서 숙제를 내주셨는데 가감승제 문제가 삼십 개나 되었다.
앞두다	have something ahead	verb	개강을 앞두다.
예산	budget	noun	예산이 얼마 없으니 꼭 필요한 물품들만 사도록 하세요.
온갖	all; every; all kinds of	adjective	민준이는 온 동네를 돌아다니면서 온갖 일에 참견해.
우려	worry; concern	noun	다들 외국어를 잘하는데 나만 이대로 가만있으면 안 될 것 같아 중국어를 배우려고 한다.
우산	umbrella; parasol	noun	내리는 빗줄기가 가느다래 나는 우산을 쓰지 않고 걸었다.
기쁨	joy	noun	기쁨을 가져다주다.
깊이	deeply; deep	adverb	깊이를 가늠하다.
꾸미다	decorate; adorn	verb	가를 꾸미다.
늘리다	extend; enlarge	verb	가계 소득을 늘리다.
무릎	knee	noun	무릎 가리개.
발견되다	be discovered; be found	verb	가필이 발견되다.
보호하다	protect; safeguard	verb	각막을 보호하다.
시스템	system	noun	시스템의 가동성.
이용	use; utilization	noun	우리 부부는 가계비 부담을 줄이기 위해서 되도록 대중교통을 이용한다.
지난달	last month	noun	추석에 돈을 많이 써서 지난달 가계는 적자였다.
지르다	yell; shout	verb	운동장을 가로지르다.
참여	participation; involvement	noun	응, 투표에 참여한 사람의 반 이상이 가결에 찬성했어.
걸음	step; walk	noun	발걸음이 가다.
겨우	with difficulty	adverb	나는 지수의 위로를 듣고서야 겨우 마음을 가다듬을 수 있었다.
마르다	dry up	verb	감정이 메마르다.
비교적	being comparative	noun	신입 사원들은 가벼이 처리할 수 있는 비교적 쉬운 업무를 맡았다.
애쓰다	try hard	verb	각고로 애쓰다.
올바르다	proper; honest	adjective	지수는 행복한 가정적 분위기 속에서 잘 자라 성품이 올바르다.
책상	desk	noun	이 책상은 고급 가구재로 만들어져서 가격이 좀 비싸다.
춥다	cold	adjective	겨울이 춥다.
흔하다	common; commonplace	adjective	사랑을 주제로 한 작품은 동서 구분 없이 흔하다.
높아지다	get higher	verb	끓는점이 높아지다.
늙다	become old; age	verb	겉늙다
단위	unit	noun	가족 단위.
무겁다	heavy; weighty	adjective	박스에 물건을 가득가득 채워서 혼자 들기에 너무 무겁다.
바람	wind	noun	친구가 팔을 잘못 휘저어 제 코를 가격하는 바람에 코피가 났어요.
상상	imagination	noun	김 감독은 풍부한 상상력을 바탕으로 가공적인 영화를 한 편 제작했다.
소득	profit; gain	noun	가계 소득.
수도	water supply; waterworks	noun	경기 중 얼굴에 가격을 당해 부상을 입을 수도 있기 때문이지.
역	station; stop	noun	None available.
인식하다	perceive; be aware of; recognize	verb	감성적으로 인식하다.
자	ruler	noun	None available.
침대	bed	noun	응, 침대를 사러 가구점에 다녀오는 길이야.
권	volume; book	noun	None available.
맺다	form	verb	가계약을 맺다.
수요	demand	noun	최근 건설 시장이 침체되자 건물을 짓는 데 필요한 강철봉의 수요도 크게 줄었다.
스타	star	noun	최근 해외에서 우리나라 스타들의 인기가 대단합니다.
시계	clock	noun	시계가 가다.
입술	lips	noun	입술이 가맣게 타다.
잎	leaf	noun	None available.
중간	middle	noun	중간 단계로 가다.
지도자	leader; head	noun	우리 회사 사장은 어떤 상황에서도 자신의 소신을 굽히지 않는 강골의 지도자이다.
천천히	slowly	adverb	천천히 가다.
구성하다	form; organize	verb	가족원을 구성하다.
대체로	roughly	adverb	장마가 길어진 탓에 채소와 과일 가격이 대체로 올랐다.
몹시	much; extremely	adverb	가을이 되자 농부들은 노랗게 익은 벼를 가을걷이하느라 몹시 바빴다.
문득	suddenly	adverb	문득 노인의 얼굴에 돌아가신 할아버지의 얼굴이 겹쳐졌다.
스포츠	sports	noun	스포츠 센터에 등록을 하려고 왔어요.
위원장	president; chairperson; leader	noun	위원장 자리는 누가 차지할지 걱정이네요.
저기	that place	pronoun	저기 운동장 가에 세워 뒀어요.
특별하다	special	adjective	기법이 특별하다.
효과적	being effective; being effectual	noun	우리 회사는 통증 치료에 효과적인 신약을 개발 중이다.
가까이	being closely	noun	가까이까지 오다.
낫다	recover; get well	verb	가뿐히 낫다.
넘어서다	go beyond	verb	경지를 넘어서다.
볶다	stir-fry	verb	가지를 볶다.
생산하다	produce	verb	가전제품을 생산하다.
언젠가	someday	adverb	고민하지 말고 꾸준히 노력하다 보면 언젠가 꿈을 이룰 수 있을 거야.
예술가	artist	noun	예술가
의도	intention; purpose; aim	noun	의도적이라고 간주하다.
저지르다	commit; make	verb	간음죄를 저지르다.
외부	east	noun	회사는 직원들을 감찰하여 회사의 비밀을 외부에 넘긴 직원을 밝혀냈다.